4 2 9 5 2 4 9 1 1 8 
2 4 5 8 5 8 7 1 3 7 
1 6 2 1 4 2 1 6 4 2 
4 3 7 3 1 6 6 4 6 9 
7 8 2 5 2 1 8 8 8 3 
1 9 3 0 2 7 0 2 2 4 
1 2 4 2 9 1 8 8 1 9 
4 2 0 4 5 0 4 7 5 0 
2 0 9 9 8 7 2 1 0 4 
7 4 2 9 1 2 3 7 1 5 
