2 2 2 2 2 2 2 2 2 2 2 2 2 2 2 2 2 2 2 2 2 2 2 2 2 2 2 2 2 2 2 2 2 2 2 2 2 2 2 2 2 2 2 2 2 2 2 2 2 2 2 2 2 2 2 2 2 2 2 2 2 2 2 2 
2 8 8 8 8 8 9 8 9 8 8 8 8 8 9 8 9 9 8 8 9 8 9 8 8 8 8 9 9 8 9 9 9 8 8 8 8 8 9 9 9 8 8 9 8 8 8 9 8 9 8 9 9 9 9 9 9 8 9 9 8 9 8 2 
2 8 9 8 8 9 8 8 9 8 9 8 8 8 9 9 9 8 8 9 9 8 8 8 9 9 9 8 9 9 8 8 8 9 8 9 9 9 8 9 8 8 9 9 8 9 8 9 9 9 8 9 9 9 8 8 9 9 8 8 8 8 9 2 
2 9 9 8 8 8 9 9 9 9 8 9 9 8 9 9 9 8 8 9 8 8 9 9 8 9 9 9 9 8 9 9 9 8 8 8 9 8 8 8 9 9 9 9 8 9 8 8 9 9 8 9 8 8 8 8 8 8 8 9 8 9 9 2 
2 8 8 8 8 9 9 8 9 8 8 8 8 9 8 8 9 9 9 8 9 9 9 9 8 9 8 9 8 9 9 8 8 8 8 9 8 9 9 9 9 9 8 8 9 9 9 8 9 8 9 8 8 8 8 9 8 8 8 9 8 9 8 2 
2 9 9 8 9 9 9 8 8 8 9 9 9 9 9 9 8 9 8 9 8 8 9 9 9 8 9 8 9 8 9 8 9 9 9 9 9 8 9 9 8 9 8 8 8 8 8 9 8 8 8 8 9 8 9 9 9 9 8 8 8 9 8 2 
2 8 9 9 8 9 9 9 8 8 8 9 8 9 8 9 9 8 8 9 9 9 9 9 8 8 8 9 8 8 8 9 9 9 9 9 8 9 9 9 8 9 9 8 9 9 9 9 8 8 8 9 9 9 9 9 9 8 8 9 8 8 8 2 
2 8 8 9 9 8 8 8 9 9 9 8 8 9 9 8 9 9 9 8 9 8 9 8 8 8 9 8 9 9 9 9 9 8 8 8 9 8 8 8 9 9 8 8 9 9 9 8 8 9 8 8 8 9 8 9 8 8 9 8 8 9 9 2 
2 9 9 9 9 8 9 9 9 9 8 8 9 8 9 9 8 9 8 9 9 9 8 8 8 9 8 8 8 8 8 8 8 9 8 9 9 9 8 9 8 8 8 9 9 9 8 9 8 9 9 8 9 9 8 9 8 8 9 8 9 9 8 2 
2 8 9 9 9 8 9 9 9 9 9 9 8 8 9 9 8 9 9 9 9 9 8 9 9 9 8 8 8 9 9 9 8 8 9 9 8 8 9 8 9 8 8 9 9 8 9 8 9 9 9 9 9 8 8 9 8 8 9 9 8 8 9 2 
2 9 8 9 8 8 8 9 8 8 9 9 8 9 9 8 9 8 9 9 8 8 8 9 9 8 8 9 8 9 9 8 8 8 9 9 9 9 9 8 8 8 8 9 8 9 9 8 9 9 9 9 9 8 8 8 9 9 9 9 8 8 9 2 
2 9 9 9 9 9 8 9 9 9 9 9 8 8 8 8 8 8 9 9 8 9 9 9 8 9 9 8 9 8 9 9 8 9 8 9 9 8 9 9 8 8 8 8 8 8 9 9 8 9 8 9 8 8 9 9 8 8 8 8 8 8 9 2 
2 8 9 8 8 8 8 8 8 8 9 9 8 8 8 9 8 8 8 9 9 9 9 8 9 8 9 9 8 9 9 8 9 8 8 9 9 9 8 8 9 9 8 9 8 8 9 8 9 8 9 8 8 9 8 9 8 9 8 8 8 8 8 2 
2 9 8 8 8 9 9 8 8 9 9 9 9 8 9 9 9 8 8 8 9 9 8 9 9 9 8 8 9 9 8 9 8 9 8 9 8 9 9 8 8 9 9 8 8 8 9 8 8 9 8 8 8 8 9 9 8 8 8 9 8 9 8 2 
2 9 8 9 9 9 9 8 9 9 9 9 8 8 9 8 8 8 9 8 8 8 8 9 8 8 8 9 8 8 8 9 9 8 9 9 9 9 9 8 9 8 8 9 8 9 8 9 8 8 8 8 8 8 9 9 8 8 9 8 8 8 9 2 
2 8 8 8 8 9 9 8 8 8 9 9 8 9 8 9 9 8 8 9 8 8 8 8 8 9 8 9 9 8 9 9 8 8 9 9 8 9 8 8 8 8 8 8 9 9 9 8 8 8 9 8 9 9 8 8 9 8 9 8 9 8 8 2 
2 8 8 9 8 8 8 9 8 8 9 9 9 9 9 9 8 9 8 8 9 8 8 8 8 8 8 8 8 8 8 8 8 9 9 8 8 9 8 8 9 9 8 8 9 9 8 9 8 8 8 9 9 9 8 9 8 8 9 9 9 8 9 2 
2 8 9 8 8 9 8 8 8 8 9 8 8 9 8 9 9 8 8 8 8 9 9 8 8 9 8 8 8 8 9 9 9 8 9 8 8 8 9 8 8 9 8 9 9 8 8 8 8 9 9 8 8 8 9 9 9 9 8 9 8 8 9 2 
2 9 9 8 9 9 8 9 8 8 9 9 9 8 9 8 8 9 8 8 8 9 8 9 9 8 8 8 8 9 8 9 8 8 9 9 8 8 8 9 9 9 9 8 8 8 8 9 8 9 9 9 8 9 8 8 8 8 8 8 8 9 9 2 
2 9 9 8 9 9 9 9 8 8 9 8 9 8 8 8 9 9 9 8 8 9 8 8 9 9 9 9 9 8 8 9 8 9 9 8 9 9 9 9 8 8 9 9 8 8 9 8 8 9 9 8 9 8 8 9 9 9 8 9 8 8 8 2 
2 9 9 8 9 8 8 8 9 9 9 9 9 9 8 8 9 9 9 9 8 9 9 8 8 8 8 9 9 9 9 9 9 8 8 8 9 8 8 8 9 8 8 8 9 8 8 9 9 9 9 9 8 9 9 9 8 9 9 8 9 8 8 2 
2 9 9 9 9 9 8 9 9 9 9 8 8 8 9 9 9 9 9 8 9 8 8 8 9 8 9 8 8 8 9 8 9 9 8 9 9 8 9 9 8 9 9 9 8 8 9 9 9 8 8 9 8 8 8 9 9 8 9 8 8 9 8 2 
2 8 8 8 8 9 9 9 8 9 8 9 8 8 8 8 8 9 8 9 9 9 8 9 9 9 9 9 9 9 8 8 8 9 9 9 8 8 9 9 8 9 9 9 8 8 9 8 8 8 8 8 9 9 9 9 8 8 9 8 9 8 8 2 
2 9 8 8 8 9 9 9 8 9 8 9 9 9 9 9 9 9 8 9 8 8 8 8 8 8 9 8 8 9 8 9 9 8 9 9 8 8 8 9 9 8 9 8 8 9 8 8 8 9 8 9 8 9 8 8 9 9 9 8 8 9 9 2 
2 9 8 8 9 9 8 9 8 9 8 9 8 9 9 8 9 8 9 9 8 9 9 8 9 9 9 8 8 9 9 9 9 9 8 9 9 9 9 9 9 8 9 9 8 9 9 8 9 9 8 8 8 8 9 8 9 8 9 9 8 8 9 2 
2 8 8 8 8 8 8 9 8 8 8 9 8 8 8 9 9 9 9 8 9 8 9 8 9 8 9 8 8 9 8 8 8 8 8 9 8 9 8 8 8 8 9 8 8 8 8 8 8 9 8 9 8 8 9 9 9 9 8 8 8 8 9 2 
2 8 9 8 9 8 9 9 8 9 8 9 8 8 9 9 9 9 9 9 9 9 8 8 9 9 8 9 8 8 9 8 8 9 8 8 8 9 9 8 8 8 9 9 8 9 8 8 8 8 9 9 8 9 9 8 8 9 9 8 9 8 9 2 
2 8 8 9 8 9 9 8 9 9 9 8 9 8 9 9 9 8 8 8 8 9 9 9 8 8 8 8 8 8 9 9 8 9 8 9 9 9 9 9 8 8 8 8 8 8 9 9 8 8 9 8 9 8 8 9 8 8 8 9 8 8 9 2 
2 9 9 8 9 8 8 9 8 8 8 8 9 8 9 8 9 8 8 8 8 9 8 8 8 9 8 9 9 9 8 8 8 9 8 8 9 8 9 9 9 8 9 9 9 8 8 8 8 9 9 9 8 8 9 9 9 8 8 9 9 8 8 2 
2 8 9 9 9 9 9 9 9 8 9 8 9 9 9 9 8 8 9 9 8 8 9 9 9 8 8 8 9 9 8 9 8 9 8 8 9 8 9 8 8 9 9 8 9 9 8 8 8 8 9 9 9 8 8 8 9 8 8 8 8 8 8 2 
2 8 8 9 9 8 9 8 8 8 8 9 9 9 9 9 9 9 8 8 9 8 8 9 8 9 9 8 9 8 9 9 8 8 8 8 8 9 8 8 8 8 8 8 9 9 9 9 9 9 9 8 9 9 9 8 9 8 8 8 8 9 9 2 
2 9 9 8 8 9 9 9 9 9 9 9 9 9 8 9 8 8 9 9 9 8 9 9 8 8 8 8 9 8 9 8 8 8 9 8 8 8 8 8 9 9 8 9 8 9 9 9 9 8 8 9 9 8 8 8 9 9 9 8 9 8 9 2 
2 9 8 8 8 8 8 9 9 9 9 9 9 9 8 9 9 8 9 8 9 8 8 8 9 8 9 8 9 9 9 9 8 8 8 9 8 9 9 9 8 9 8 8 8 9 9 9 8 8 9 8 9 9 8 9 9 9 8 9 9 8 8 2 
2 9 8 9 8 9 8 8 9 8 8 8 9 9 8 9 9 8 9 9 9 8 9 8 8 8 9 9 9 8 9 8 9 8 9 9 8 8 8 8 8 8 9 9 9 9 9 9 9 9 9 9 9 9 9 9 9 8 9 8 8 9 9 2 
2 8 9 9 9 8 8 8 9 9 8 9 8 8 8 9 0 2 9 0 8 4 0 8 5 5 3 8 5 9 9 8 9 9 9 9 9 9 8 9 9 9 9 9 9 8 8 8 8 9 8 8 9 9 8 8 8 9 8 9 8 8 9 2 
2 8 9 8 9 9 8 8 8 8 8 9 9 9 9 9 0 1 3 4 0 9 8 0 4 8 3 5 4 4 4 9 8 9 9 8 8 8 8 8 9 9 8 9 9 9 8 8 9 8 8 9 9 8 9 9 9 9 8 8 9 9 8 2 
2 9 9 8 9 8 8 8 9 9 9 8 9 9 9 8 5 4 3 1 5 9 0 2 2 4 5 8 5 4 5 8 8 8 8 8 9 9 8 8 8 8 8 9 8 8 8 9 9 8 8 8 8 8 9 9 8 8 9 9 8 8 8 2 
2 9 9 8 8 8 9 9 8 9 9 8 8 8 8 8 0 9 8 4 4 9 5 5 8 0 8 2 4 1 3 8 8 9 8 8 9 9 8 8 8 9 8 9 8 9 9 8 9 8 8 9 9 9 8 9 8 8 9 9 9 8 9 2 
2 8 9 8 8 9 8 9 8 8 8 9 9 8 9 9 2 4 5 9 0 0 5 3 4 1 3 4 9 8 8 9 8 9 8 8 8 9 8 9 8 8 9 9 9 9 9 8 9 8 9 9 8 9 8 8 8 8 9 9 8 8 8 2 
2 8 8 9 9 8 8 8 8 8 9 9 8 9 9 8 1 5 3 9 3 1 3 9 1 2 4 8 1 9 5 9 8 8 9 9 8 8 9 9 9 9 9 8 8 9 8 8 9 8 8 8 9 9 8 8 9 8 8 9 8 8 9 2 
2 8 8 9 8 8 9 9 8 8 9 9 8 9 9 9 5 2 0 8 2 2 1 1 0 3 3 0 8 9 9 9 8 8 8 9 8 8 9 8 8 8 9 9 9 9 8 9 8 8 9 9 9 9 8 8 8 8 9 8 9 9 8 2 
2 8 9 9 8 9 8 8 8 9 9 8 9 9 8 8 9 3 2 0 3 4 3 4 4 5 2 4 3 9 2 9 8 8 8 8 9 9 8 9 8 8 9 8 8 8 8 8 9 8 9 9 8 9 8 8 9 9 9 9 8 9 9 2 
2 8 8 9 9 8 9 9 8 9 9 8 8 9 8 8 4 9 2 9 0 3 0 3 1 2 5 2 4 0 8 8 8 8 9 8 8 8 8 8 8 9 8 9 8 9 9 9 9 9 8 9 8 9 8 8 9 8 9 8 9 8 9 2 
2 9 9 8 8 8 8 9 9 9 8 8 8 9 9 9 8 9 2 8 5 2 3 0 3 5 4 8 2 8 9 9 9 8 8 9 8 9 9 8 9 9 8 9 8 9 9 8 9 9 8 9 9 8 8 8 8 9 9 8 8 9 8 2 
2 8 8 9 9 9 9 8 9 8 8 9 9 8 9 8 9 4 9 9 2 1 3 3 2 2 0 0 8 1 4 8 9 9 8 8 9 8 9 8 9 8 8 8 9 9 8 9 8 8 8 9 9 8 9 9 8 8 9 9 9 9 8 2 
2 9 9 8 9 9 9 8 9 9 9 9 8 8 8 8 3 9 3 9 2 2 2 8 2 8 9 3 2 8 0 9 8 9 8 9 8 9 9 9 9 9 8 9 8 9 9 8 8 8 9 9 8 9 9 9 9 9 8 9 9 8 8 2 
2 9 8 9 8 8 8 9 9 8 9 8 8 8 8 9 5 3 1 5 2 0 1 5 1 0 2 1 8 8 5 8 8 8 8 9 8 8 9 9 8 8 9 8 8 8 9 9 9 9 8 8 9 8 9 9 9 8 9 8 8 9 9 2 
2 9 9 8 9 9 9 9 8 9 8 9 9 9 9 9 0 3 3 3 9 3 4 1 3 5 4 5 5 8 8 8 8 8 9 8 8 9 8 9 9 9 8 9 9 9 9 9 9 9 9 9 8 8 8 8 9 9 8 9 9 9 8 2 
2 9 8 8 8 9 9 9 8 9 8 8 9 8 9 9 0 8 8 9 3 4 8 8 4 1 2 3 0 1 2 8 9 8 8 8 8 8 8 8 9 8 9 8 8 9 8 8 9 9 8 9 9 9 9 9 9 9 9 8 9 8 8 2 
2 9 8 9 9 8 8 9 9 8 8 9 9 8 8 8 8 8 8 8 8 8 8 8 9 9 8 8 9 8 9 8 8 8 9 8 9 9 8 8 9 8 9 8 9 9 9 9 8 8 8 9 8 8 8 8 8 8 8 9 8 8 9 2 
2 8 8 8 8 8 9 8 8 9 8 9 8 9 8 9 9 8 9 8 9 8 8 9 8 8 8 9 8 8 8 8 8 8 8 9 8 8 8 8 9 9 8 8 8 9 8 9 9 8 8 8 8 9 8 8 8 8 8 9 8 9 9 2 
2 9 9 8 9 9 9 9 9 9 8 8 8 9 9 8 9 9 9 9 9 8 9 8 9 9 8 8 8 8 9 9 9 8 9 9 8 9 9 8 9 8 8 8 9 8 9 9 8 9 9 9 8 9 8 9 8 8 9 8 8 8 9 2 
2 8 8 8 8 9 8 9 9 8 8 9 8 9 8 8 9 9 9 9 8 9 8 9 9 8 8 8 8 8 9 9 8 9 9 9 8 9 8 8 8 9 8 9 8 8 8 9 9 9 9 8 9 9 8 8 9 8 8 9 8 9 8 2 
2 8 9 9 9 8 9 8 8 8 9 8 8 9 8 8 9 9 8 8 8 9 8 9 8 9 8 8 8 9 9 9 8 8 8 8 9 8 9 9 9 8 9 8 9 8 8 9 9 8 8 9 9 9 9 9 9 9 9 9 9 8 9 2 
2 9 8 9 8 8 9 9 9 9 8 8 8 8 9 9 9 9 9 9 8 9 8 8 9 9 8 9 9 9 8 9 9 8 8 9 8 9 8 9 8 8 8 9 9 9 9 9 8 9 8 9 8 9 8 9 8 9 9 8 9 8 9 2 
2 8 8 9 9 9 9 8 9 9 9 8 9 9 8 9 9 8 8 8 8 9 8 8 8 9 8 8 9 8 9 8 9 8 9 8 9 8 8 8 8 8 8 9 8 9 8 8 8 8 8 8 9 9 8 9 9 8 9 8 8 9 9 2 
2 8 9 8 8 9 9 8 9 8 9 9 9 8 9 8 8 9 8 8 9 9 8 9 8 8 9 8 9 9 8 9 8 9 8 9 9 8 8 9 9 9 8 9 8 8 9 9 8 9 9 9 9 9 8 8 8 8 9 8 9 8 9 2 
2 9 9 8 9 8 8 9 9 9 8 9 9 8 9 8 8 9 9 8 8 8 9 9 8 8 9 9 8 8 8 8 9 8 9 9 9 8 9 9 8 9 8 9 8 9 9 9 9 9 8 8 9 9 8 9 9 9 9 9 8 9 8 2 
2 8 9 8 9 9 9 8 8 9 9 8 8 9 9 8 9 9 9 8 8 9 9 8 9 8 9 8 9 9 8 8 9 9 8 9 9 8 9 9 8 9 9 9 9 8 8 8 8 9 8 9 9 8 8 8 8 8 8 9 8 8 9 2 
2 9 9 8 8 9 8 8 8 8 8 9 8 9 9 9 8 8 9 9 9 8 9 8 9 9 9 8 8 9 9 9 8 9 8 8 9 9 9 8 9 9 9 9 8 9 8 9 8 9 8 8 8 8 8 8 8 8 9 8 9 9 8 2 
2 8 9 9 9 9 8 9 8 8 9 9 8 8 9 8 9 9 9 9 8 9 8 9 9 8 9 9 9 9 8 8 9 8 8 9 8 8 9 9 8 8 9 8 9 9 8 9 8 9 8 8 9 9 8 8 8 8 9 9 8 8 9 2 
2 8 9 9 9 8 8 8 9 8 9 9 9 8 9 8 9 8 8 8 8 9 8 9 9 8 9 9 8 8 8 8 8 9 8 9 8 9 9 9 8 8 8 8 8 8 9 8 8 8 8 8 9 9 9 8 8 8 8 9 8 8 9 2 
2 8 9 8 9 8 9 8 9 9 9 8 9 9 8 8 8 8 8 8 9 8 8 8 9 8 8 8 9 8 8 9 9 8 8 8 8 8 8 8 9 8 8 8 8 9 8 9 8 8 9 9 9 9 9 9 9 9 9 9 9 8 8 2 
2 2 2 2 2 2 2 2 2 2 2 2 2 2 2 2 2 2 2 2 2 2 2 2 2 2 2 2 2 2 2 2 2 2 2 2 2 2 2 2 2 2 2 2 2 2 2 2 2 2 2 2 2 2 2 2 2 2 2 2 2 2 2 2 
