6 5 3 3 5 5 7 0 2 4 
0 3 4 0 9 3 3 9 4 9 
9 6 4 6 1 5 6 8 8 3 
9 6 9 6 4 6 7 3 1 8 
3 9 0 3 0 0 9 2 8 2 
5 2 3 7 9 3 3 7 0 8 
3 2 7 0 1 0 3 9 2 3 
4 5 1 8 8 2 1 7 5 4 
2 9 7 6 2 8 7 9 3 5 
9 3 1 1 5 8 1 5 1 7 
