2 2 2 2 2 2 2 2 2 2 2 2 2 2 2 2 2 2 2 2 2 2 2 2 2 2 2 2 2 2 2 2 2 2 2 2 2 2 2 2 2 2 2 2 2 2 2 2 2 2 2 2 2 2 2 2 2 2 2 2 2 2 2 2 
2 9 8 9 8 9 9 9 9 9 9 8 8 9 9 9 9 9 9 9 8 9 8 8 9 8 9 9 8 9 9 9 8 8 8 9 9 9 9 8 8 8 8 8 9 8 9 8 9 8 9 8 8 8 9 9 9 9 9 9 9 8 9 2 
2 8 8 9 8 8 9 9 9 8 8 8 9 9 8 9 9 8 8 8 8 8 8 8 8 9 8 8 8 9 9 8 8 8 8 9 8 9 8 9 8 9 8 8 8 8 9 9 8 8 8 8 8 8 9 8 9 9 8 9 9 8 9 2 
2 9 9 9 9 9 8 8 9 9 9 8 9 9 8 8 9 8 9 8 9 9 9 9 8 9 8 9 8 9 9 9 8 8 8 8 8 8 8 8 8 9 9 8 9 9 9 8 9 8 8 8 9 9 8 9 8 9 9 8 8 8 9 2 
2 8 8 8 8 8 9 8 8 8 8 8 9 9 9 9 9 9 9 8 8 9 8 8 9 8 9 9 9 9 9 9 8 8 8 9 9 8 9 8 9 9 8 9 8 8 8 8 9 9 8 9 8 8 9 9 9 8 9 9 8 8 8 2 
2 8 8 9 9 9 8 9 8 9 9 8 9 9 9 9 9 8 9 9 8 9 9 8 8 8 8 9 9 9 9 8 9 8 9 8 8 8 9 8 9 9 8 9 8 9 9 9 9 8 9 8 9 8 9 9 9 8 8 9 8 8 9 2 
2 9 8 9 8 9 9 9 9 8 8 9 9 8 8 9 9 9 9 8 9 8 8 9 9 8 9 9 8 9 9 9 9 9 8 9 9 9 8 9 8 8 8 9 8 9 9 8 8 8 9 8 9 8 8 8 8 8 8 9 9 8 8 2 
2 9 9 9 8 8 8 8 9 8 8 9 9 9 8 8 8 8 9 8 9 8 8 9 8 8 9 9 9 9 9 8 9 8 9 9 9 9 8 9 9 8 8 8 9 8 8 8 8 8 9 9 9 9 8 9 9 9 9 8 9 8 9 2 
2 8 8 8 9 8 9 8 8 8 9 9 9 8 8 8 9 9 8 9 9 9 9 9 9 8 8 9 9 9 8 9 8 8 8 8 8 8 8 8 9 8 8 9 8 9 8 9 8 8 8 8 8 8 9 8 9 9 9 8 8 8 9 2 
2 9 8 8 8 9 8 9 9 9 9 8 9 9 8 8 9 9 8 9 9 8 9 8 8 8 8 9 8 8 8 8 9 8 8 9 9 8 8 9 9 8 8 8 9 9 8 8 8 9 8 9 8 8 8 9 9 9 9 9 8 8 8 2 
2 8 8 9 8 9 9 9 9 9 8 8 8 8 9 8 9 8 9 8 9 8 8 9 8 9 9 8 8 9 9 9 9 8 9 8 8 8 9 9 8 8 9 8 8 9 9 9 9 8 9 8 9 8 9 8 9 9 8 8 8 8 9 2 
2 8 9 8 9 8 8 9 8 8 9 9 8 8 9 9 8 9 9 8 8 8 8 8 9 8 8 9 8 9 9 9 8 8 8 8 9 8 9 8 9 9 9 8 8 8 8 9 8 8 8 9 8 9 8 8 8 9 8 9 8 8 9 2 
2 9 8 8 9 8 9 9 8 8 9 9 9 9 8 8 9 8 8 9 8 9 8 9 8 8 9 8 9 9 8 9 8 9 9 8 9 8 9 8 9 8 8 8 9 9 8 9 8 8 8 9 9 8 9 9 8 8 9 9 9 9 8 2 
2 8 9 9 8 8 8 8 8 9 8 8 9 9 8 9 8 8 9 8 9 9 8 8 8 9 8 8 8 9 9 9 8 8 9 8 9 8 8 9 8 8 8 8 8 9 8 8 9 9 8 9 9 9 8 9 8 9 8 9 8 9 9 2 
2 9 8 9 9 8 8 9 8 9 9 8 9 9 8 9 8 8 8 8 8 8 9 8 9 9 9 9 8 9 9 9 9 9 8 9 8 9 8 8 9 8 9 8 8 9 9 8 8 9 9 9 8 8 9 9 8 8 9 8 9 8 8 2 
2 8 8 9 8 9 9 9 9 8 9 9 9 9 8 9 9 8 9 8 9 8 8 8 9 8 8 9 8 8 9 8 9 9 9 9 9 9 8 9 9 8 9 8 8 8 9 8 9 8 8 8 8 9 9 8 8 9 9 9 8 9 9 2 
2 9 8 9 8 8 8 8 8 9 8 9 8 8 9 8 9 9 8 9 8 9 8 8 8 9 8 9 8 9 9 9 8 8 8 9 9 8 9 9 9 9 9 8 9 9 8 9 8 8 8 8 8 8 9 9 9 9 8 9 8 9 8 2 
2 8 8 9 8 9 8 9 9 8 8 8 9 8 8 8 9 8 8 8 9 8 8 9 9 8 9 8 8 9 9 8 8 9 8 8 9 8 8 8 9 9 8 8 8 8 8 9 8 8 9 9 8 9 9 8 8 8 9 9 8 9 8 2 
2 8 8 9 8 8 8 9 8 8 8 8 9 9 9 8 8 9 8 8 8 8 8 9 9 9 8 8 8 9 9 8 9 8 8 8 9 8 9 8 8 9 8 9 9 8 9 9 8 8 9 8 8 9 9 8 8 9 8 9 8 8 9 2 
2 9 9 8 9 8 8 8 8 9 8 8 8 8 9 9 8 8 9 8 8 8 9 9 9 9 9 9 8 9 8 8 8 8 8 9 9 9 9 9 8 8 8 9 8 9 9 8 8 9 8 9 9 8 8 9 9 9 9 9 9 8 8 2 
2 9 9 8 8 9 8 8 9 9 8 9 8 8 9 9 8 8 8 8 8 8 8 9 9 8 8 8 8 9 9 8 8 8 9 8 8 9 8 9 9 8 9 9 8 8 9 9 9 8 9 8 8 9 9 9 8 9 8 9 9 9 8 2 
2 8 9 9 8 8 9 9 9 8 9 9 9 9 8 8 9 9 8 8 9 8 8 8 8 8 8 9 8 8 8 8 9 8 8 8 8 9 8 8 9 9 8 8 8 8 8 9 8 8 9 8 8 9 8 8 8 8 9 9 8 8 8 2 
2 9 8 8 8 8 9 9 8 8 8 8 8 8 8 8 9 8 8 9 9 9 8 9 9 8 9 8 9 9 8 9 9 9 8 9 8 8 8 9 8 8 8 9 8 8 9 9 9 8 8 9 8 9 9 9 8 8 8 8 9 8 9 2 
2 9 9 9 8 8 9 8 9 9 8 8 8 8 8 9 9 9 8 9 9 9 8 8 9 8 8 9 8 9 9 9 8 9 9 8 9 8 9 9 9 9 8 8 9 9 8 8 9 9 8 9 8 9 8 9 9 9 8 9 8 8 8 2 
2 9 8 9 8 8 8 8 9 8 8 8 8 9 8 8 9 8 9 8 9 9 8 9 9 8 9 8 8 9 8 8 8 8 8 8 9 8 8 8 9 9 8 9 8 8 9 8 9 9 8 8 9 8 8 9 8 9 9 9 8 9 8 2 
2 9 8 9 8 8 8 9 9 9 9 8 9 9 8 9 8 8 9 9 8 9 8 8 8 8 9 8 8 8 9 9 8 8 9 9 9 8 9 8 8 8 8 9 8 9 9 8 9 8 8 9 8 9 9 8 8 8 9 9 9 8 8 2 
2 9 9 9 9 9 8 9 9 8 8 9 9 9 9 9 9 9 8 9 9 9 8 9 9 8 9 8 8 8 9 8 9 9 9 9 8 8 9 8 9 8 8 8 9 9 9 9 8 8 9 8 8 8 9 8 8 8 8 8 9 8 8 2 
2 9 9 8 9 8 9 9 8 9 9 8 9 8 9 9 9 8 9 9 9 9 9 8 8 9 9 8 9 9 9 9 8 9 9 8 8 9 8 9 8 8 9 8 9 9 8 8 9 9 8 8 9 8 9 9 8 8 9 8 9 8 8 2 
2 8 8 8 9 8 9 8 8 8 8 8 9 8 8 8 9 8 8 9 8 9 8 9 8 8 8 9 8 8 8 8 9 8 8 8 8 8 9 8 8 8 8 8 8 8 9 9 8 9 9 9 9 8 9 8 8 8 9 9 8 8 9 2 
2 8 8 8 8 8 8 9 9 9 9 9 9 8 8 9 9 8 9 9 8 8 8 8 9 8 8 9 9 9 9 8 9 8 8 8 8 9 8 9 8 8 9 8 9 8 8 9 9 8 9 8 8 9 9 8 9 9 9 8 8 8 9 2 
2 9 9 9 8 8 8 9 8 9 9 8 8 8 9 8 9 9 8 8 8 9 9 9 8 9 9 9 9 8 8 9 8 9 9 8 9 9 9 8 9 8 8 9 9 9 8 9 9 9 8 8 9 8 9 9 8 9 8 9 9 8 8 2 
2 8 8 8 8 9 9 9 9 9 8 9 8 9 9 9 9 9 8 8 8 8 8 9 8 9 8 8 8 8 8 9 8 8 9 8 8 9 8 9 9 9 9 8 8 9 8 8 8 9 8 9 8 9 8 8 8 9 8 8 9 8 9 2 
2 8 8 8 9 9 8 8 8 9 8 9 9 8 9 8 8 9 8 9 9 8 9 8 8 8 8 9 9 8 8 9 8 9 9 9 8 9 8 8 9 9 8 9 8 9 8 9 9 8 8 8 9 9 9 8 9 8 9 9 9 9 9 2 
2 8 8 9 8 9 9 9 8 9 9 9 8 8 8 8 8 8 8 9 9 9 9 8 8 8 8 9 8 9 8 8 9 9 8 9 8 9 8 8 9 8 8 9 9 8 8 8 9 9 8 8 8 9 8 8 9 9 8 8 8 9 9 2 
2 8 8 9 8 9 8 9 9 9 8 8 9 8 9 8 8 8 8 9 8 9 8 9 9 9 8 9 8 8 9 8 8 9 8 8 9 8 8 9 9 8 8 8 8 9 9 9 9 9 9 8 9 9 8 9 8 8 8 8 9 8 8 2 
2 8 8 9 8 8 8 9 9 8 8 8 8 9 8 8 9 9 8 9 8 9 9 9 9 8 8 9 9 9 8 9 8 8 8 8 8 9 8 8 8 8 8 9 8 8 8 8 8 8 9 9 9 9 9 9 8 9 9 9 8 8 8 2 
2 8 8 8 8 8 9 9 9 9 8 8 8 9 9 9 9 8 9 9 8 8 9 9 9 9 9 9 8 9 9 9 9 8 9 9 9 8 8 8 9 8 8 9 9 9 9 8 9 8 9 8 8 9 9 8 9 8 8 9 9 8 9 2 
2 8 8 9 8 9 8 8 8 9 9 8 8 9 9 8 8 9 8 8 8 8 9 8 9 9 9 8 8 8 8 9 9 9 8 8 9 8 9 8 9 8 9 8 9 8 9 9 8 8 9 8 9 9 8 8 9 8 8 8 8 8 8 2 
2 9 8 9 8 8 8 8 9 9 8 8 9 8 8 8 9 8 8 9 8 9 9 9 9 8 9 9 9 8 9 8 8 8 8 8 9 8 8 9 8 9 8 8 9 8 8 8 9 9 8 9 9 8 8 8 8 9 9 9 8 8 8 2 
2 8 9 8 8 9 9 8 9 8 9 8 9 8 8 8 9 9 8 8 9 8 9 9 8 8 9 9 8 8 8 9 8 9 8 9 9 8 8 8 9 8 8 8 8 9 9 8 9 8 9 8 9 9 9 8 8 8 9 9 8 8 9 2 
2 8 9 8 9 8 9 8 8 9 9 9 9 9 9 8 9 1 1 1 9 1 1 9 9 1 1 8 1 8 1 8 8 8 9 9 9 8 9 8 9 8 8 9 9 8 9 9 8 9 9 9 8 8 9 9 9 9 9 8 8 9 9 2 
2 9 8 9 8 8 9 9 9 9 9 8 9 8 8 9 9 1 1 1 1 1 1 1 9 1 1 1 1 1 1 1 8 8 8 8 9 8 9 8 9 9 9 9 9 8 8 9 9 9 8 9 8 9 9 9 8 9 9 9 9 9 8 2 
2 8 8 8 8 9 9 9 8 8 9 8 8 8 8 9 8 1 9 1 1 1 1 1 1 1 1 1 1 9 1 9 9 9 8 8 8 8 8 8 9 8 9 8 9 9 9 8 9 8 8 9 8 9 8 8 9 8 9 8 8 9 9 2 
2 9 8 9 9 9 9 9 8 9 9 8 9 8 9 9 8 9 9 1 1 8 1 9 1 1 1 1 1 1 1 1 9 8 8 8 9 8 8 9 9 9 9 8 8 9 8 9 9 8 9 9 9 8 8 8 8 9 9 9 8 8 9 2 
2 9 9 8 8 9 9 9 9 9 9 8 8 9 9 9 8 1 9 1 1 1 1 1 1 1 1 1 1 8 9 8 8 8 9 8 8 9 8 8 9 9 8 8 9 8 9 9 8 8 9 8 8 8 9 8 9 8 9 9 8 9 8 2 
2 8 9 9 9 8 9 8 9 8 9 9 8 8 9 8 8 1 1 1 1 1 1 1 1 1 1 1 1 1 1 1 9 8 9 8 9 9 8 9 9 8 8 9 9 8 9 9 8 9 9 8 9 8 8 9 9 8 8 8 8 9 9 2 
2 9 8 8 9 8 9 9 8 8 8 8 8 8 9 9 9 1 1 1 1 1 1 1 1 1 1 1 9 9 1 1 8 9 8 8 8 9 8 9 8 9 8 9 8 8 8 9 8 8 9 8 8 8 9 9 8 8 9 8 8 8 9 2 
2 8 8 9 8 8 8 9 9 9 9 8 9 8 8 9 8 9 1 8 1 1 1 1 1 1 1 1 8 1 1 1 9 9 9 9 8 9 9 8 9 8 8 8 9 9 8 8 9 9 9 8 8 9 9 8 8 8 9 9 9 9 8 2 
2 8 8 8 8 8 9 8 9 9 8 9 8 9 8 9 8 1 1 1 1 1 1 1 1 1 1 1 1 1 8 9 8 9 8 9 8 9 9 9 9 9 8 8 8 8 9 8 9 9 8 9 8 9 8 9 9 9 8 9 9 8 8 2 
2 9 9 8 8 8 8 8 9 9 9 8 9 8 9 9 8 1 1 8 8 1 1 1 1 1 1 1 1 1 8 1 8 8 8 9 8 8 8 9 8 9 8 8 8 9 8 9 8 8 8 9 9 9 9 9 8 9 8 9 9 8 8 2 
2 9 8 8 9 9 9 8 9 9 8 8 8 8 8 9 9 1 1 1 1 1 1 1 1 1 1 1 1 1 1 9 9 9 8 9 8 9 8 8 8 9 9 9 9 9 8 8 9 8 9 9 9 9 8 8 8 8 9 9 8 8 9 2 
2 8 8 9 9 8 8 9 8 8 8 9 8 8 9 8 8 1 1 1 1 1 1 1 1 8 8 1 1 1 1 1 8 8 8 8 9 9 8 9 8 9 8 9 9 9 9 9 8 9 9 8 9 9 9 8 9 8 9 9 8 9 9 2 
2 8 9 9 8 9 9 8 9 9 8 8 8 9 8 9 8 1 1 1 1 1 8 8 9 9 8 1 1 1 1 8 9 8 9 8 8 9 8 8 9 9 8 9 9 9 9 8 9 8 8 8 8 8 9 9 9 8 9 8 8 8 9 2 
2 8 9 8 9 9 8 8 9 8 8 8 9 8 9 9 8 9 1 1 1 8 8 9 1 9 1 1 8 1 1 1 8 9 9 9 9 9 9 9 8 8 9 8 8 8 8 9 8 8 9 8 8 8 8 8 8 9 8 9 8 9 9 2 
2 8 9 9 8 9 9 9 9 9 9 9 8 9 8 9 9 8 9 1 1 9 8 1 1 1 1 1 8 8 1 1 8 8 9 9 9 8 8 8 9 9 8 8 9 8 9 9 9 8 8 9 8 8 8 8 8 9 9 9 9 8 9 2 
2 9 8 8 8 9 9 8 9 8 9 8 9 9 8 9 8 8 9 8 8 9 8 8 9 9 9 8 9 8 8 9 8 9 9 8 8 9 8 8 8 8 8 9 8 8 8 8 8 9 8 9 8 9 9 8 9 8 8 9 8 8 8 2 
2 8 8 9 8 8 8 9 9 9 9 9 9 9 8 8 9 8 8 9 9 8 8 8 8 9 8 9 8 9 8 9 9 8 8 8 8 8 9 9 8 8 9 9 9 8 8 9 9 8 8 8 8 9 9 8 8 8 8 8 8 8 8 2 
2 9 8 9 8 9 9 9 9 8 8 9 9 9 8 9 8 9 8 9 9 8 8 8 9 8 9 9 9 9 8 9 9 9 9 9 8 8 8 9 9 8 8 8 8 8 8 9 8 9 8 8 8 8 9 8 8 8 9 8 8 9 9 2 
2 9 9 8 8 9 8 9 8 8 9 9 8 8 8 9 9 9 8 8 8 8 8 9 9 9 9 8 9 9 8 8 8 8 9 8 8 9 8 9 9 9 8 9 9 9 8 8 9 8 9 9 9 8 8 8 9 9 8 9 9 9 9 2 
2 8 8 9 9 8 8 9 8 9 8 9 8 9 8 9 8 9 8 9 8 8 8 9 9 8 9 8 8 9 8 8 9 9 9 8 9 9 8 9 8 9 8 9 9 9 8 8 8 8 8 9 9 8 9 9 9 8 8 8 8 8 8 2 
2 8 9 8 8 8 8 8 8 8 9 9 9 9 8 9 8 9 8 9 8 9 8 8 9 9 8 8 9 8 8 8 8 9 8 9 8 8 8 8 9 9 9 8 9 8 9 8 9 9 8 8 9 9 8 8 8 8 9 9 8 8 9 2 
2 8 9 8 8 8 9 9 8 9 8 9 8 9 8 9 8 8 9 9 8 8 8 9 9 9 8 9 9 8 9 8 8 9 9 8 9 9 9 9 9 9 9 9 8 8 9 9 9 8 9 8 9 9 9 9 8 8 9 8 9 8 8 2 
2 8 8 8 9 9 8 8 9 9 8 9 9 8 9 9 9 9 8 8 8 9 8 9 9 8 8 9 8 8 8 9 8 9 8 8 9 8 8 9 9 8 8 9 8 8 8 9 9 8 8 9 8 9 8 8 8 8 9 8 8 8 8 2 
2 2 2 2 2 2 2 2 2 2 2 2 2 2 2 2 2 2 2 2 2 2 2 2 2 2 2 2 2 2 2 2 2 2 2 2 2 2 2 2 2 2 2 2 2 2 2 2 2 2 2 2 2 2 2 2 2 2 2 2 2 2 2 2 
