4 0 6 5 1 8 2 3 4 0 
6 0 0 5 0 9 9 9 2 2 
8 3 9 8 4 4 9 7 5 8 
9 2 7 5 2 7 1 1 5 4 
3 0 8 1 0 5 4 6 2 6 
7 5 4 7 2 0 8 6 5 9 
7 0 5 4 0 6 5 4 5 6 
2 5 5 8 7 2 2 1 9 5 
3 3 4 0 2 0 7 7 5 0 
6 1 7 0 6 3 6 3 7 7 
