2 2 2 2 2 2 2 2 2 2 2 2 2 2 2 2 2 2 2 2 2 2 2 2 2 2 2 2 2 2 2 2 2 2 2 2 2 2 2 2 2 2 2 2 2 2 2 2 2 2 2 2 2 2 2 2 2 2 2 2 2 2 2 2 
2 9 8 8 9 8 8 9 8 8 9 8 9 9 8 9 9 8 9 9 8 8 8 8 8 9 9 9 9 9 8 8 8 8 9 8 9 8 9 9 8 8 9 9 8 8 9 8 9 9 8 9 8 8 9 8 9 9 9 8 9 9 9 2 
2 9 9 8 9 9 9 9 8 8 9 8 8 8 9 9 9 9 9 9 8 8 8 9 9 9 8 9 9 9 8 9 9 9 8 8 8 9 8 8 8 9 9 9 9 9 9 8 8 8 9 8 8 9 9 9 8 8 8 8 9 8 9 2 
2 8 9 8 9 8 9 8 8 9 8 9 8 8 9 8 9 9 9 8 8 9 9 9 9 8 9 2 4 0 8 2 9 3 2 9 4 1 0 8 9 8 8 9 9 9 8 9 9 8 9 9 8 8 8 8 9 8 9 9 8 9 8 2 
2 8 9 8 9 9 8 8 9 9 9 8 8 8 8 9 8 9 8 9 8 9 9 9 9 8 2 3 3 8 3 0 2 1 5 9 3 4 9 3 2 9 9 9 8 9 9 9 8 9 8 8 8 8 8 8 8 8 8 8 9 8 9 2 
2 9 9 9 9 9 9 8 8 9 9 8 9 9 9 8 8 9 8 9 8 8 8 9 9 9 2 2 8 1 0 4 2 2 0 4 8 4 1 1 9 8 9 8 9 9 9 9 9 8 9 9 9 9 9 9 8 8 9 9 8 8 9 2 
2 8 8 9 9 8 9 8 9 9 9 9 9 9 8 9 9 9 8 9 8 8 8 8 8 8 3 5 0 0 8 5 9 5 0 5 4 8 9 9 2 9 8 8 8 8 8 9 9 9 9 9 8 9 8 9 9 8 9 8 9 9 8 2 
2 8 8 8 9 9 8 9 9 9 9 9 8 8 9 8 9 9 9 9 8 9 9 9 8 8 1 8 5 9 0 3 2 3 1 5 1 1 0 2 5 9 8 8 9 9 9 8 8 9 9 8 9 8 9 8 9 8 9 8 9 9 8 2 
2 8 9 8 8 8 9 9 9 9 8 9 8 9 8 8 8 9 9 9 9 8 8 8 9 9 4 0 3 5 2 0 2 4 5 5 5 3 2 4 5 8 9 8 8 9 9 9 9 8 9 9 9 9 9 8 8 9 9 8 9 9 9 2 
2 8 8 8 9 8 9 9 8 8 8 8 8 8 9 8 9 9 9 9 9 9 8 8 9 8 5 4 4 2 3 1 4 1 2 4 5 4 3 8 8 9 9 8 8 9 9 8 9 9 8 9 8 8 8 8 9 8 8 9 8 9 9 2 
2 8 8 8 9 9 9 9 9 9 9 9 8 8 9 8 9 9 8 9 8 9 9 9 8 8 8 0 3 4 8 4 5 5 4 0 2 3 9 2 3 8 8 8 8 8 8 9 8 9 8 8 8 8 8 9 9 9 8 9 8 9 8 2 
2 8 9 8 9 8 8 9 8 9 8 8 8 9 8 9 8 8 8 9 8 8 9 8 9 8 4 4 2 3 4 5 4 0 2 3 4 4 8 0 4 9 9 8 8 8 9 8 8 9 9 8 8 8 9 8 9 9 9 9 8 8 8 2 
2 8 9 8 8 9 8 8 9 9 9 9 8 9 9 9 9 9 8 9 9 8 8 8 8 9 4 2 4 2 4 4 4 0 0 2 4 9 8 9 8 8 9 8 9 9 8 9 9 8 9 9 9 9 8 9 8 8 9 8 9 9 9 2 
2 9 9 8 9 8 8 8 9 9 9 9 8 8 9 9 8 8 9 9 9 9 8 9 8 9 0 1 5 8 1 2 3 5 5 3 4 9 2 4 4 8 8 8 8 8 8 9 9 9 8 9 8 9 9 9 9 8 9 8 9 9 8 2 
2 9 9 8 8 8 8 9 9 9 8 9 9 9 8 8 9 8 9 9 8 8 9 9 8 8 4 9 9 4 9 3 5 8 9 0 5 3 1 9 8 9 9 8 8 9 9 9 8 9 8 9 8 8 8 8 9 8 8 9 8 8 9 2 
2 9 8 9 8 8 9 8 8 8 8 8 9 8 9 8 8 9 8 9 9 8 9 9 8 8 4 8 1 4 9 5 9 1 3 4 2 1 9 2 1 8 8 8 8 8 8 9 9 9 9 8 9 9 8 9 9 8 9 9 8 8 8 2 
2 9 9 8 9 9 9 8 8 9 9 8 9 9 9 9 8 8 9 9 8 8 8 8 8 8 2 1 3 2 0 4 9 0 4 0 1 5 2 2 9 8 8 8 8 9 9 9 9 8 9 9 9 8 8 9 9 9 9 8 9 8 8 2 
2 9 9 8 9 8 9 8 9 8 9 8 9 9 8 9 8 8 8 8 9 8 8 8 9 9 8 3 4 9 8 5 1 1 5 4 9 9 9 0 2 9 9 9 9 9 9 9 8 8 8 9 8 9 9 9 9 9 9 8 8 8 8 2 
2 9 8 9 9 9 8 9 9 9 9 8 8 8 8 9 8 8 8 9 8 8 9 9 9 8 8 9 8 9 9 8 8 8 8 9 8 8 8 9 9 8 8 9 9 9 8 8 8 9 9 8 8 8 9 9 8 9 8 8 9 9 9 2 
2 8 9 8 8 9 8 9 8 8 8 8 8 9 8 8 8 9 8 8 9 8 9 9 9 8 8 9 9 9 9 9 9 8 8 9 9 9 8 9 9 8 8 8 9 9 9 9 8 9 9 9 8 9 8 8 8 8 8 8 9 9 8 2 
2 8 8 9 8 8 8 8 9 8 8 9 9 9 9 9 8 8 8 9 8 8 8 9 8 8 9 9 9 8 9 8 9 9 9 8 8 8 9 8 8 9 9 9 8 8 9 9 9 8 9 8 8 9 8 9 8 8 8 8 8 9 8 2 
2 8 9 8 8 8 8 9 9 9 8 9 8 8 8 8 8 8 9 9 9 8 9 9 9 9 9 8 9 8 9 8 8 9 8 8 8 8 9 9 9 9 9 9 9 9 8 8 9 8 9 9 9 8 8 9 9 8 9 8 9 8 8 2 
2 9 8 9 9 8 8 9 8 9 8 8 9 9 9 8 9 8 8 9 9 8 8 8 9 9 8 8 8 8 9 9 8 9 8 9 9 9 9 9 9 8 8 9 8 8 9 9 9 9 8 8 9 9 8 8 9 9 9 9 9 9 9 2 
2 8 9 9 8 8 8 8 8 9 8 8 9 8 9 8 8 8 9 9 9 8 8 9 9 8 9 8 8 9 8 8 8 8 9 9 8 9 8 8 9 8 9 8 8 9 8 9 9 8 8 9 8 9 9 8 8 8 9 9 9 9 8 2 
2 8 9 8 9 9 8 9 8 9 9 9 9 9 8 9 9 9 8 8 8 8 9 8 8 8 8 8 9 9 9 9 9 8 9 8 9 8 9 9 8 8 9 9 8 8 8 9 8 9 9 8 9 9 8 9 8 8 8 9 8 9 8 2 
2 9 8 8 9 9 8 9 9 9 8 9 8 9 8 9 9 9 8 9 9 9 8 9 8 9 9 8 9 8 8 8 9 9 9 9 8 8 9 8 8 8 9 9 8 8 8 9 9 8 8 8 8 9 9 9 8 9 8 9 8 8 8 2 
2 9 9 9 9 8 9 9 8 9 9 8 9 8 8 9 9 8 9 8 8 9 9 8 9 9 8 8 9 9 9 8 8 9 8 8 9 8 8 8 8 9 8 8 8 8 9 9 9 9 8 8 9 9 9 9 8 8 9 8 8 9 8 2 
2 8 8 9 9 8 9 8 8 8 9 8 8 8 9 8 9 8 8 8 8 9 9 8 9 8 8 8 8 8 8 8 8 9 9 8 9 9 8 8 9 9 8 9 8 8 9 9 8 8 8 9 9 8 9 9 9 8 9 8 9 9 9 2 
2 8 8 9 8 8 9 8 9 8 8 8 9 9 8 9 9 8 9 9 9 9 9 8 9 9 8 9 9 9 9 8 8 9 8 8 9 9 9 9 9 9 9 9 9 8 9 8 8 9 9 8 9 8 9 9 9 9 9 9 9 9 8 2 
2 8 9 8 9 8 9 8 8 9 9 9 8 9 8 8 8 9 8 8 8 8 8 9 8 8 9 9 9 9 9 9 8 8 9 9 9 9 9 8 8 9 9 8 8 9 9 8 8 8 9 9 8 8 9 8 8 9 9 9 9 8 8 2 
2 8 8 9 9 8 8 9 9 8 8 8 9 8 9 8 9 9 8 9 8 9 9 9 9 8 8 8 9 9 8 9 8 8 8 9 8 9 8 8 9 8 8 9 9 8 9 9 8 8 8 8 8 9 9 9 9 9 9 8 8 8 8 2 
2 9 9 9 9 8 9 9 8 8 8 9 8 9 8 9 9 8 9 9 9 8 9 9 9 8 8 8 8 8 9 9 8 9 9 9 9 9 9 8 8 9 8 8 9 8 8 8 8 8 8 9 9 9 9 8 8 8 8 9 8 9 9 2 
2 8 8 8 9 8 8 8 9 9 9 8 9 8 9 9 8 8 9 8 8 8 8 9 9 8 9 8 8 9 9 8 9 8 8 9 8 9 9 9 8 8 8 9 9 9 8 9 8 8 8 9 8 9 9 9 9 8 9 8 9 8 8 2 
2 9 8 8 9 9 8 8 8 8 8 8 9 9 8 9 8 9 9 8 9 8 8 8 9 8 9 9 8 8 8 9 8 9 9 8 8 8 9 9 8 9 8 9 9 8 9 9 9 9 9 8 9 9 9 8 9 9 9 9 9 9 9 2 
2 9 9 8 9 9 8 8 9 9 9 9 8 9 8 9 9 8 9 8 9 9 9 9 8 8 9 9 8 9 9 9 8 9 9 8 9 9 9 8 9 9 8 9 8 9 9 8 9 9 9 8 8 9 8 8 8 9 9 8 9 8 9 2 
2 9 9 8 9 9 9 9 9 8 8 8 9 8 8 8 8 8 8 9 8 9 8 9 8 8 8 9 8 8 9 8 8 9 8 8 9 9 8 8 8 8 8 9 8 9 8 9 9 8 9 8 9 9 9 9 8 8 8 8 8 8 9 2 
2 8 9 8 8 9 8 9 9 8 8 8 8 9 8 9 9 9 8 9 9 8 8 9 8 9 8 9 8 8 9 8 9 9 8 9 9 8 9 8 9 8 8 8 9 9 8 8 9 8 9 8 8 8 8 8 9 9 8 9 8 9 9 2 
2 8 9 9 9 9 9 9 8 9 9 9 9 8 9 8 9 8 8 8 8 8 9 8 8 8 8 9 9 9 9 8 8 9 9 8 8 9 9 9 8 8 8 9 8 8 9 8 9 9 9 8 8 8 9 9 8 9 9 8 9 8 9 2 
2 8 9 9 8 8 8 8 9 8 8 9 9 9 8 9 9 8 8 9 9 8 9 9 8 8 9 9 9 8 9 9 8 9 9 9 9 9 9 8 8 8 9 9 9 9 8 9 8 8 9 9 8 9 8 9 8 8 9 9 8 9 8 2 
2 8 9 9 9 8 9 9 8 8 8 9 8 9 9 8 8 8 9 8 9 9 8 8 8 8 9 8 9 9 9 8 8 8 8 9 8 8 9 8 8 9 8 9 9 9 8 9 9 9 8 8 9 8 9 8 8 8 9 9 8 8 9 2 
2 8 9 8 8 9 8 9 9 9 8 8 8 8 9 8 8 9 8 8 9 8 9 9 9 9 9 8 8 8 9 8 9 9 8 9 8 9 8 9 9 9 9 9 9 8 9 8 8 8 9 8 9 9 9 8 8 8 8 8 9 9 9 2 
2 8 9 9 8 8 8 8 8 9 8 8 9 8 8 8 9 8 9 8 9 9 8 8 9 9 8 8 9 9 9 9 9 9 9 8 9 9 8 9 8 8 9 8 9 8 8 9 8 9 9 8 9 8 9 8 9 8 9 9 8 9 8 2 
2 9 9 9 9 8 8 9 9 8 8 9 9 8 9 9 9 8 8 8 8 9 9 9 9 8 9 8 8 8 8 9 9 8 8 8 8 8 8 8 9 8 9 9 8 9 8 9 8 8 8 9 9 8 9 8 8 8 9 8 9 8 9 2 
2 8 8 8 9 8 9 9 9 9 9 8 8 9 9 9 9 8 8 8 8 8 8 8 9 8 8 9 9 8 8 8 8 9 9 8 8 8 8 9 8 8 9 8 8 8 8 8 8 9 9 9 8 8 9 9 9 8 8 9 8 9 9 2 
2 8 8 8 8 8 9 9 8 9 8 8 8 9 8 8 9 8 8 9 8 8 9 8 8 9 9 8 8 9 9 8 9 8 9 8 9 8 9 8 9 9 8 8 8 9 8 9 9 8 9 8 9 8 8 9 9 8 9 9 8 9 9 2 
2 9 8 8 9 9 9 8 8 9 8 8 8 9 9 8 8 9 9 8 8 9 8 8 8 8 8 8 9 8 9 8 9 9 8 9 9 9 9 8 9 9 8 8 8 8 9 9 8 9 8 9 8 8 8 9 9 9 8 9 9 8 8 2 
2 8 9 8 8 8 8 9 9 8 8 9 8 9 9 9 8 8 9 8 9 8 9 9 8 8 8 8 8 9 9 9 9 9 9 9 9 8 9 9 8 9 9 8 9 9 8 8 9 9 8 9 8 9 8 8 8 9 8 8 9 8 9 2 
2 8 8 9 9 8 9 9 8 8 9 8 8 9 8 9 9 8 9 9 9 8 9 9 9 9 8 9 9 9 9 8 9 8 8 8 8 9 8 8 8 9 8 9 8 8 9 9 9 9 8 9 8 8 9 8 8 8 9 9 8 8 8 2 
2 9 9 9 9 8 8 8 9 9 8 9 9 8 8 8 8 8 8 9 8 8 9 8 9 8 9 8 9 9 8 8 9 8 9 9 8 8 8 8 9 9 9 9 9 8 9 8 9 9 8 8 9 9 9 9 9 9 8 9 8 9 9 2 
2 9 8 8 8 9 9 8 9 9 9 9 9 9 9 8 8 8 9 8 9 8 9 9 9 9 9 9 8 9 8 9 9 8 8 8 8 8 8 8 8 9 8 9 9 9 8 9 9 9 8 9 9 9 8 9 9 9 9 8 8 9 9 2 
2 9 8 8 9 8 9 8 8 9 9 8 9 8 9 9 8 9 8 8 9 8 8 9 9 8 8 8 8 9 9 9 8 8 8 9 8 8 8 8 8 9 9 9 8 9 9 9 9 8 9 8 9 8 9 8 8 8 9 9 8 8 9 2 
2 9 8 8 9 8 8 9 8 9 9 8 9 9 9 8 8 8 8 9 8 9 8 9 8 9 8 9 9 8 9 8 9 8 8 9 9 8 9 8 8 9 9 8 9 9 9 8 9 9 9 8 8 9 8 9 9 9 9 8 8 8 8 2 
2 9 8 8 9 8 8 8 9 8 9 8 8 9 8 9 8 8 8 9 9 8 8 9 9 9 8 9 8 8 8 8 9 8 9 9 8 8 9 9 9 9 8 9 8 8 9 8 9 9 9 8 9 9 9 8 8 9 9 9 8 9 9 2 
2 8 9 8 9 8 9 9 9 9 8 8 9 9 9 8 9 9 9 9 9 8 9 9 8 9 9 8 8 8 8 8 9 9 9 8 8 8 8 8 9 8 9 9 9 8 8 8 8 9 9 9 8 8 9 8 8 9 9 8 9 9 9 2 
2 8 9 9 9 8 8 8 9 9 8 8 8 8 8 8 9 8 8 9 8 8 8 9 9 9 8 8 8 8 9 9 9 9 8 9 9 8 9 8 8 8 9 9 8 8 8 9 8 8 8 8 8 8 9 9 9 8 8 8 8 8 8 2 
2 8 8 9 8 8 9 9 8 8 8 9 9 9 9 8 9 8 8 9 8 8 8 8 9 8 9 9 8 8 9 9 9 8 9 8 8 9 8 9 8 8 8 9 8 9 9 9 8 8 8 9 9 8 8 9 9 9 8 8 8 9 8 2 
2 8 9 9 9 8 8 8 9 8 8 8 8 8 9 9 8 9 8 9 9 8 9 8 9 9 8 9 8 8 8 9 9 9 9 9 9 8 9 8 8 8 9 8 8 8 9 8 9 8 8 9 9 9 8 8 9 9 9 9 9 9 8 2 
2 8 9 9 8 9 9 9 8 9 9 8 8 9 9 8 9 8 8 9 8 9 9 8 9 8 9 8 9 9 9 9 9 8 8 8 8 9 8 8 9 9 9 9 9 9 8 8 8 9 9 8 8 9 9 8 9 8 9 8 9 8 8 2 
2 9 9 9 9 8 8 8 8 9 8 8 8 9 9 8 8 8 9 9 8 9 8 9 8 8 8 9 9 9 8 9 8 9 8 9 9 9 9 9 8 8 8 8 8 9 8 8 8 8 9 9 9 9 8 9 8 8 8 8 8 9 8 2 
2 9 9 8 8 9 8 8 9 9 8 8 8 9 8 8 9 8 9 8 9 9 9 9 8 8 8 9 8 8 8 8 8 9 8 9 8 9 8 9 9 9 9 9 8 8 8 8 8 9 9 8 9 8 9 9 9 9 8 9 9 8 9 2 
2 8 8 8 8 8 9 8 8 8 8 8 8 9 9 8 8 9 9 9 9 9 8 8 9 9 8 9 8 8 8 8 8 8 9 8 9 8 8 9 8 9 9 8 8 9 9 9 8 8 8 9 8 9 9 9 9 8 8 9 8 9 8 2 
2 9 8 8 8 8 9 9 8 9 8 9 8 9 9 8 9 9 9 9 8 8 8 9 8 8 8 9 8 8 8 9 9 9 9 8 9 8 9 9 8 8 8 8 8 8 9 8 9 8 9 9 9 8 9 9 8 9 9 8 8 9 9 2 
2 8 8 9 8 9 9 9 9 8 8 9 9 8 9 8 9 9 8 9 8 9 8 8 8 9 9 9 8 8 8 8 9 9 9 8 8 9 9 8 8 8 8 9 8 8 8 9 9 9 9 8 9 8 9 8 9 9 9 9 8 9 8 2 
2 2 2 2 2 2 2 2 2 2 2 2 2 2 2 2 2 2 2 2 2 2 2 2 2 2 2 2 2 2 2 2 2 2 2 2 2 2 2 2 2 2 2 2 2 2 2 2 2 2 2 2 2 2 2 2 2 2 2 2 2 2 2 2 
