2 2 2 2 2 2 2 2 2 2 2 2 2 2 2 2 2 2 2 2 2 2 2 2 2 2 2 2 2 2 2 2 2 2 2 2 2 2 2 2 2 2 2 2 2 2 2 2 2 2 2 2 2 2 2 2 2 2 2 2 2 2 2 2 
2 8 8 8 9 9 9 9 8 9 9 9 8 9 9 9 9 8 9 8 8 9 9 9 8 8 9 9 8 9 9 8 9 9 9 8 8 9 9 9 9 8 9 9 9 9 8 9 8 8 8 9 9 9 9 8 8 8 9 9 8 9 9 2 
2 9 8 9 8 8 8 8 8 9 8 9 9 8 8 8 8 8 8 9 8 8 8 8 9 9 9 9 8 9 9 9 8 8 9 8 9 9 8 8 8 9 9 8 9 8 8 9 9 8 9 8 8 9 8 8 9 8 9 8 8 8 9 2 
2 9 8 8 9 9 9 8 9 8 8 9 9 9 8 9 9 9 9 8 9 9 9 9 9 9 9 8 8 8 8 8 9 8 8 8 8 9 8 9 9 8 9 9 8 8 9 8 9 9 8 9 9 8 9 8 9 8 9 9 9 9 9 2 
2 9 8 9 9 9 8 9 9 9 9 9 9 8 8 8 8 8 8 9 8 9 8 8 8 8 8 9 9 9 8 9 8 9 9 9 9 8 8 9 9 9 9 9 9 9 8 8 9 8 8 8 9 9 9 9 9 9 8 9 8 8 9 2 
2 9 9 9 8 8 8 8 8 9 8 9 8 9 8 8 9 8 8 9 9 9 8 8 8 8 8 9 8 8 9 8 8 9 8 8 9 9 8 9 9 9 9 8 9 8 8 8 8 9 8 8 8 8 8 9 9 9 9 9 8 9 8 2 
2 8 9 9 9 8 9 9 9 8 9 9 8 9 9 8 9 8 9 9 9 9 8 9 9 9 9 9 9 8 8 9 8 8 8 8 9 8 9 8 8 8 9 9 8 8 8 8 9 8 9 9 9 9 9 9 9 8 8 9 9 8 8 2 
2 8 9 8 8 8 9 8 8 8 8 9 8 8 8 9 9 8 9 8 9 9 9 9 9 9 8 8 9 8 8 8 9 8 8 8 9 9 9 9 9 8 9 8 9 9 8 9 9 8 8 8 8 9 8 9 8 9 9 9 8 9 9 2 
2 8 9 8 9 8 9 8 9 9 9 9 9 8 9 8 8 9 8 8 9 8 8 8 8 9 9 8 9 9 9 8 9 8 9 8 8 8 8 8 9 9 9 9 8 9 8 8 8 9 8 8 8 8 8 8 8 9 8 9 9 9 9 2 
2 9 8 9 9 8 9 8 8 9 8 8 9 8 8 8 8 8 8 9 9 9 8 9 9 9 9 9 8 8 9 8 8 9 8 8 8 9 9 8 9 9 9 9 8 8 8 9 8 8 8 9 9 9 8 9 9 8 8 8 8 8 8 2 
2 8 9 9 9 9 8 8 9 9 9 9 8 8 8 9 9 8 9 9 8 9 9 8 8 8 8 9 9 8 9 9 9 8 8 9 8 8 9 8 9 8 8 9 8 8 8 8 8 9 8 9 8 9 8 8 8 9 8 8 8 9 9 2 
2 8 9 8 9 8 8 9 9 8 9 9 9 8 9 9 8 8 9 8 8 9 9 9 9 9 8 8 8 9 9 8 9 9 8 8 8 8 8 9 9 8 9 9 9 8 9 9 9 8 9 9 8 9 8 8 8 8 9 9 8 8 8 2 
2 8 9 8 9 9 9 8 8 9 9 9 9 9 8 8 8 9 9 8 9 9 9 8 8 8 8 8 8 8 9 8 9 8 8 8 9 9 9 9 8 8 8 9 8 9 8 9 9 9 9 8 8 9 8 9 9 8 8 8 9 8 9 2 
2 9 9 9 8 9 9 9 8 8 9 9 8 8 8 8 8 8 8 8 9 9 9 8 9 9 8 9 9 9 9 9 8 8 8 9 8 8 9 8 8 8 9 8 8 9 8 9 9 8 9 9 9 9 8 9 9 8 9 8 8 8 8 2 
2 9 9 9 8 8 9 8 9 9 9 9 9 9 9 9 8 9 9 8 8 9 9 9 8 9 9 8 9 9 8 9 9 9 9 8 9 8 9 9 8 8 9 9 8 9 9 9 9 9 8 9 8 8 8 8 8 8 8 8 9 9 8 2 
2 9 8 9 8 9 8 8 8 9 8 9 8 8 9 8 8 9 8 8 8 8 8 8 8 9 9 8 9 8 9 9 8 9 8 8 8 9 8 8 9 8 8 9 9 9 9 9 8 8 9 8 8 9 8 8 8 9 9 9 9 8 8 2 
2 9 9 8 4 2 2 4 1 3 9 3 8 0 3 1 5 5 5 8 8 9 8 9 8 8 8 9 8 8 9 8 9 9 8 8 8 9 9 8 8 8 9 9 8 8 9 8 8 9 8 8 9 9 8 9 8 8 9 9 9 8 9 2 
2 9 8 9 9 8 9 1 9 3 4 4 9 1 2 8 9 3 3 9 9 9 9 9 9 8 9 8 9 9 8 9 8 8 8 9 9 9 8 9 9 8 9 8 9 8 9 9 9 9 9 8 9 9 9 8 9 8 8 9 8 8 8 2 
2 8 9 9 9 2 3 5 3 3 4 8 0 9 9 9 3 5 8 8 8 9 8 9 9 9 9 9 8 8 8 9 9 8 9 8 8 9 8 9 8 8 9 9 9 8 8 9 9 9 9 9 8 9 9 8 9 9 8 8 9 8 9 2 
2 8 9 8 3 5 9 2 1 1 2 2 3 5 3 0 8 5 9 8 8 8 9 8 9 9 9 9 9 9 8 9 8 8 8 8 9 8 8 8 9 9 8 8 9 8 8 8 8 9 9 9 8 8 9 8 9 9 8 8 9 9 9 2 
2 8 8 8 8 9 8 8 2 1 0 4 1 4 3 0 3 0 5 9 9 8 8 8 9 9 8 9 9 8 9 8 9 8 9 9 9 9 8 9 8 8 9 9 9 9 8 9 9 8 8 9 8 9 8 8 8 9 9 9 8 8 8 2 
2 8 9 8 3 1 4 9 5 1 5 4 1 2 3 8 1 5 8 9 9 8 8 8 9 9 8 9 9 9 8 8 9 8 8 9 8 8 9 9 9 9 8 8 9 8 8 9 9 8 8 9 8 9 8 8 9 9 9 9 9 8 8 2 
2 9 9 8 5 5 9 8 1 2 2 3 5 2 1 2 4 0 9 8 8 9 8 8 9 9 8 9 9 8 9 9 8 8 8 9 8 8 8 9 8 8 8 9 9 9 9 8 8 8 8 9 9 9 9 8 8 9 8 9 9 8 8 2 
2 8 8 9 3 4 4 8 1 2 5 0 0 1 0 0 5 1 8 9 8 8 9 9 9 9 8 8 9 9 9 8 8 9 8 8 9 9 9 9 9 8 8 9 9 8 8 8 8 8 8 9 9 8 9 8 8 9 9 8 9 8 8 2 
2 9 8 9 1 3 5 5 2 5 3 3 5 1 2 1 4 2 0 9 9 8 8 8 8 8 9 8 9 9 9 9 9 8 8 9 9 8 8 9 9 9 9 9 8 9 8 8 8 8 8 8 9 9 8 8 8 8 9 8 9 9 9 2 
2 9 9 8 0 4 2 2 5 1 0 5 0 2 4 1 1 1 3 9 9 8 9 8 8 8 8 9 8 9 9 8 9 9 8 8 9 8 8 8 9 9 9 9 8 8 8 8 8 8 9 9 8 8 8 8 9 9 8 9 8 8 8 2 
2 8 8 9 2 8 8 3 3 3 3 3 5 0 2 2 3 3 4 9 8 8 8 9 8 8 8 9 8 8 8 9 8 9 8 8 9 8 8 9 8 8 8 9 9 8 8 9 9 9 8 8 9 8 9 9 9 9 9 8 8 9 9 2 
2 8 8 8 3 8 0 8 0 5 8 1 2 3 0 9 4 2 8 8 8 9 9 9 9 9 8 8 9 8 9 9 8 9 9 9 8 8 8 8 8 9 9 9 8 8 9 9 8 9 8 8 9 8 8 8 9 9 8 9 8 8 8 2 
2 8 8 9 3 0 4 0 0 4 0 4 2 0 9 3 1 5 8 8 9 8 8 8 9 9 9 8 9 9 8 8 8 8 8 8 8 8 8 9 8 8 9 9 8 8 9 8 9 9 9 9 8 9 9 9 9 9 8 9 9 9 9 2 
2 8 9 9 5 1 3 3 5 8 3 8 3 9 0 3 0 8 2 8 8 9 8 8 8 8 9 9 8 8 9 8 9 8 9 8 9 8 9 8 8 9 9 9 8 8 8 8 9 9 8 9 9 9 8 9 9 8 9 9 9 9 9 2 
2 9 9 8 2 1 8 8 2 8 5 8 5 5 1 3 2 2 9 8 9 8 8 9 8 8 9 9 9 8 8 9 8 8 8 9 8 9 9 9 9 9 9 8 9 9 9 8 9 9 8 8 9 8 9 8 9 9 8 8 8 9 8 2 
2 8 8 8 9 8 9 9 8 8 8 9 8 8 9 9 8 9 8 9 8 9 9 9 9 8 9 8 8 9 8 8 8 8 8 8 8 8 9 8 9 8 9 8 8 8 8 9 8 8 9 8 9 9 9 8 9 9 9 8 8 8 9 2 
2 8 8 8 8 8 9 9 9 9 9 9 9 9 8 9 9 9 9 9 8 9 9 9 8 9 9 9 9 9 9 8 9 8 9 8 8 8 9 9 8 8 8 8 8 8 8 8 9 8 8 8 9 9 8 8 9 9 8 8 8 9 9 2 
2 9 8 9 8 9 8 8 8 8 8 9 9 8 9 8 8 9 9 9 9 9 8 8 9 8 9 8 9 9 9 9 9 9 8 9 9 8 9 8 9 9 9 8 8 9 8 8 9 8 9 9 8 9 9 8 8 8 9 9 9 8 9 2 
2 9 9 8 8 8 9 8 9 8 9 8 9 9 8 8 8 8 8 9 9 9 9 9 9 8 9 9 8 8 8 9 8 9 9 8 9 8 8 8 9 9 9 8 9 8 9 8 9 9 9 8 9 9 8 9 8 9 9 9 9 8 8 2 
2 8 9 8 8 8 9 9 9 8 8 8 9 8 9 9 9 9 9 9 8 8 9 9 9 8 8 9 8 8 8 8 8 8 9 8 8 9 8 8 9 8 8 9 8 9 9 8 8 9 8 8 9 8 8 8 9 8 8 8 8 9 8 2 
2 8 8 8 9 8 9 8 8 8 9 8 8 8 9 9 9 8 8 8 9 9 9 8 9 8 8 8 9 9 8 8 9 9 8 9 9 8 9 9 8 8 9 9 9 9 9 8 8 9 8 9 8 8 8 9 8 8 8 8 8 8 8 2 
2 8 9 8 8 9 9 8 8 8 8 9 9 9 8 8 9 9 8 9 8 8 9 9 9 8 8 9 9 9 8 8 9 8 9 9 8 8 8 8 8 8 9 8 8 8 9 9 9 8 9 8 8 9 9 9 8 8 8 9 8 9 8 2 
2 8 9 8 9 8 9 8 9 8 9 8 8 9 9 8 9 8 8 9 8 8 9 9 8 8 9 9 8 9 8 8 8 8 8 9 8 9 8 8 9 8 8 8 8 8 9 9 9 9 9 8 8 9 8 8 9 8 8 9 8 9 8 2 
2 8 8 8 8 8 9 8 9 8 8 9 9 9 8 8 9 9 8 8 8 8 8 8 8 8 8 8 8 9 9 8 8 9 9 9 8 8 9 8 8 8 8 8 9 9 8 9 8 8 8 9 9 8 8 8 9 9 9 9 8 8 8 2 
2 9 8 9 8 9 9 8 9 8 8 9 9 8 8 9 8 8 8 9 9 8 8 9 8 9 8 8 8 9 8 8 8 9 9 8 9 8 8 9 8 9 9 9 9 9 9 9 9 9 9 9 8 8 8 8 9 8 8 9 8 8 9 2 
2 9 8 8 9 9 8 9 8 9 9 8 9 8 9 8 8 9 9 8 8 9 9 9 8 9 8 9 9 8 9 8 8 8 9 8 8 8 9 8 9 9 9 9 8 8 9 8 9 8 8 9 8 8 8 8 8 9 9 8 8 8 8 2 
2 8 9 9 9 8 9 8 9 8 9 9 8 8 8 8 8 8 8 8 8 8 8 9 9 8 9 9 8 9 8 9 8 8 8 9 9 9 9 9 9 8 8 9 9 8 8 8 9 9 9 8 9 9 8 8 8 9 9 9 9 9 9 2 
2 9 8 9 8 8 9 8 8 9 9 8 9 9 9 8 8 9 8 8 8 9 9 8 8 9 8 8 8 8 9 9 8 9 8 8 8 8 8 9 9 8 9 9 8 9 9 9 8 9 9 9 9 9 9 9 8 8 8 8 9 9 9 2 
2 8 8 8 8 9 8 8 8 8 9 9 8 9 9 9 8 8 9 9 9 8 9 8 8 9 8 9 8 8 9 9 8 9 9 8 8 8 8 9 9 9 8 9 9 8 8 8 8 9 9 9 9 8 9 9 9 9 9 8 8 8 9 2 
2 8 9 8 9 8 9 9 9 9 8 9 9 8 8 8 9 8 8 9 8 9 8 9 8 9 9 8 9 9 8 8 8 8 8 9 9 8 9 8 8 9 8 8 8 9 9 8 9 9 9 8 9 8 8 9 8 9 8 8 9 8 9 2 
2 9 8 9 8 8 8 9 9 9 8 8 9 9 9 9 9 8 8 8 9 9 8 9 8 8 8 9 8 8 8 9 8 8 9 8 9 9 9 8 8 9 8 9 8 9 8 9 8 8 8 9 8 8 8 8 9 8 9 9 8 8 9 2 
2 8 9 9 9 8 8 8 8 9 8 9 8 8 8 8 8 9 9 8 9 8 9 8 8 8 8 9 9 8 8 9 9 8 8 8 8 9 9 9 9 9 8 9 8 8 8 9 8 8 8 8 9 8 9 8 9 9 8 8 9 9 9 2 
2 9 8 9 8 9 9 9 8 9 8 9 9 9 9 9 9 9 8 8 8 9 8 9 8 9 8 8 8 9 9 9 9 8 9 9 8 9 9 9 8 8 8 9 9 8 9 8 8 9 8 8 8 9 8 8 9 8 9 9 9 9 8 2 
2 9 8 9 8 9 8 9 8 9 8 9 8 8 9 9 9 9 8 9 8 9 8 8 8 8 9 8 8 8 9 9 8 9 9 9 9 9 8 8 8 9 9 8 8 9 8 8 8 8 9 9 9 9 8 9 9 8 9 8 9 9 9 2 
2 8 9 9 8 9 9 9 9 8 9 8 8 8 8 9 8 9 9 9 9 8 9 8 8 9 9 8 8 9 9 8 9 8 9 9 8 9 8 8 9 9 8 8 8 9 9 8 9 9 8 9 8 8 9 8 9 8 9 9 8 9 9 2 
2 8 8 8 8 9 8 8 9 9 8 8 8 9 9 9 9 8 8 8 9 8 8 8 9 9 9 8 8 9 9 9 9 8 9 9 9 8 8 8 9 8 8 8 9 8 8 8 8 8 8 9 9 8 8 9 8 9 8 8 9 9 8 2 
2 9 9 8 8 8 9 8 9 9 8 8 9 9 8 8 8 9 9 9 8 8 8 8 8 8 9 8 9 8 9 9 8 8 8 8 9 8 9 9 9 8 8 8 8 9 9 9 8 8 8 8 8 8 9 9 9 8 9 9 9 9 8 2 
2 8 9 8 8 9 9 8 9 8 9 8 8 8 9 9 9 8 8 8 9 8 9 9 8 9 9 9 8 8 9 9 8 8 8 9 9 9 8 9 8 9 8 9 8 8 8 9 8 8 9 9 9 9 9 9 9 8 8 9 9 8 9 2 
2 8 9 8 9 9 9 8 9 9 8 9 8 9 9 9 9 9 9 9 9 8 9 9 9 8 8 9 8 9 9 9 8 8 8 9 8 8 8 9 9 8 9 8 8 9 8 8 8 9 8 8 8 8 9 8 9 8 9 8 9 8 8 2 
2 9 9 8 8 8 9 8 8 9 8 9 8 9 9 9 8 8 8 8 8 8 9 8 9 9 9 9 8 9 8 9 8 8 9 9 9 8 9 9 9 8 8 9 9 8 8 8 8 9 8 8 8 9 9 8 9 8 9 8 9 9 8 2 
2 9 8 9 9 9 8 8 8 9 8 8 9 9 9 8 8 9 9 9 9 8 8 9 8 8 9 8 8 8 9 8 8 9 9 9 9 9 8 9 8 8 8 9 8 9 9 9 8 8 8 9 8 8 9 9 8 9 9 8 9 9 8 2 
2 8 9 8 9 8 9 9 9 8 9 8 8 8 9 9 8 8 9 9 9 8 8 8 8 9 8 9 8 9 9 9 9 8 9 9 8 8 8 8 8 9 8 9 9 9 8 9 8 9 8 9 8 9 9 9 9 9 9 9 9 8 9 2 
2 8 8 8 9 9 9 9 9 8 9 9 9 9 8 9 9 9 8 9 8 8 9 9 8 8 8 9 9 8 9 8 9 8 8 8 8 9 8 8 9 8 8 9 9 8 9 8 8 9 8 9 9 8 8 8 9 9 8 8 9 8 9 2 
2 8 9 9 9 8 9 8 8 9 8 9 9 8 9 9 9 8 8 8 8 9 8 9 8 9 9 8 8 8 8 9 9 9 8 8 8 9 9 9 8 9 9 9 8 9 8 8 8 8 8 9 8 8 9 9 8 9 9 8 9 9 8 2 
2 8 8 8 8 8 9 8 9 9 8 8 9 8 9 9 8 9 9 8 9 9 8 8 8 9 9 8 9 8 8 8 9 9 9 9 8 9 9 8 8 8 9 9 9 9 9 8 9 8 9 8 9 9 9 8 8 9 8 9 8 8 9 2 
2 8 9 8 8 8 8 8 9 9 8 8 8 9 9 8 9 9 9 9 8 9 8 9 8 9 9 8 8 8 8 8 9 8 9 9 9 9 8 9 9 8 8 9 8 8 9 8 8 9 8 8 8 8 8 9 8 9 9 9 8 8 9 2 
2 9 9 9 8 9 9 8 9 9 9 8 9 9 8 9 8 9 9 9 8 9 8 8 9 9 8 9 8 8 9 9 8 8 8 8 8 9 8 9 9 9 8 8 9 8 8 8 8 9 9 9 9 8 8 9 9 9 9 9 8 9 8 2 
2 2 2 2 2 2 2 2 2 2 2 2 2 2 2 2 2 2 2 2 2 2 2 2 2 2 2 2 2 2 2 2 2 2 2 2 2 2 2 2 2 2 2 2 2 2 2 2 2 2 2 2 2 2 2 2 2 2 2 2 2 2 2 2 
