6 9 9 2 5 2 0 7 6 1 
7 5 6 9 9 0 7 0 3 0 
5 0 0 8 9 0 5 7 8 8 
8 7 9 6 3 6 3 3 7 9 
2 4 2 6 1 3 2 4 8 6 
5 3 4 3 8 8 3 7 1 9 
8 0 7 1 9 8 1 9 2 2 
2 7 7 4 3 1 5 5 7 8 
6 1 8 7 3 5 2 1 3 1 
9 3 3 7 3 2 2 8 1 8 
