2 2 2 2 2 2 2 2 2 2 2 2 2 2 2 2 2 2 2 2 2 2 2 2 2 2 2 2 2 2 2 2 2 2 2 2 2 2 2 2 2 2 2 2 2 2 2 2 2 2 2 2 2 2 2 2 2 2 2 2 2 2 2 2 
2 8 9 9 9 9 8 8 9 8 9 8 8 8 9 8 8 9 8 8 8 9 8 9 8 8 9 9 8 9 8 8 9 8 9 9 8 8 9 9 9 9 9 8 8 8 9 8 9 8 8 8 8 9 8 8 9 8 9 9 9 8 9 2 
2 8 8 9 8 8 8 8 9 8 9 9 9 8 8 9 9 9 9 9 9 8 9 9 9 9 8 9 9 8 9 9 9 8 9 8 8 8 9 8 9 8 9 8 8 8 8 9 8 9 9 8 8 8 9 9 8 8 9 9 9 9 8 2 
2 8 8 8 9 9 8 8 9 8 8 8 8 8 8 9 8 9 9 8 8 8 9 9 8 9 8 8 9 8 9 9 9 8 8 9 8 9 8 8 8 8 9 9 9 9 9 8 9 9 9 8 9 8 9 8 9 9 9 8 9 8 9 2 
2 9 9 9 8 8 9 9 9 9 9 8 9 9 8 8 8 9 8 8 8 8 8 9 9 8 8 8 9 9 8 9 8 9 9 9 9 9 8 8 8 9 8 9 8 8 9 8 8 9 9 9 9 9 8 9 9 9 9 8 9 9 9 2 
2 9 8 9 8 8 9 8 8 9 8 9 8 9 8 8 8 8 8 8 8 9 9 8 9 8 8 8 9 8 9 9 8 9 8 9 9 8 8 9 8 8 9 9 8 9 8 8 9 8 9 9 9 8 9 8 9 9 8 9 8 8 8 2 
2 8 9 8 9 9 8 8 8 8 8 8 9 9 9 9 9 9 8 9 8 8 8 8 9 9 9 8 8 9 8 8 8 8 8 8 8 8 8 9 8 8 9 9 8 8 8 9 9 9 9 9 9 9 8 9 9 8 9 8 9 9 8 2 
2 9 8 9 8 9 8 8 8 8 9 9 8 9 9 9 8 9 9 8 8 9 8 8 8 9 8 9 8 8 9 9 8 9 9 9 8 9 9 9 9 8 9 8 9 9 9 9 8 8 8 8 9 8 9 9 9 9 9 8 9 9 8 2 
2 9 8 9 9 8 8 8 8 8 9 9 8 9 9 9 9 8 9 9 9 8 9 8 9 9 8 8 9 8 8 8 9 8 9 8 9 9 9 9 8 9 9 9 9 8 8 8 8 8 9 8 8 9 8 8 9 9 9 9 9 8 9 2 
2 9 8 8 9 9 8 9 9 8 8 9 8 9 8 8 8 8 9 8 8 8 9 8 9 9 8 9 9 9 8 9 8 8 8 8 8 9 8 9 8 8 8 8 8 9 9 9 8 8 9 9 8 9 8 8 8 9 8 9 8 9 8 2 
2 8 8 8 8 8 9 8 9 9 9 9 8 8 9 8 9 9 9 9 9 8 9 8 9 9 9 9 8 8 9 9 8 9 8 9 8 8 8 8 9 9 8 9 9 8 9 9 9 8 9 9 8 9 8 9 9 8 8 8 8 8 9 2 
2 8 8 9 8 8 9 9 8 8 9 9 8 8 9 9 8 8 9 9 8 8 8 8 8 9 9 9 9 8 9 9 9 8 8 9 9 8 9 9 8 9 8 9 8 8 9 9 9 8 9 9 8 8 8 8 8 8 8 9 8 8 8 2 
2 9 8 9 9 8 8 8 8 8 9 8 9 8 8 8 8 8 8 9 8 8 9 9 9 9 8 8 9 8 8 9 9 9 8 9 8 8 8 8 9 9 9 9 8 8 9 8 8 9 8 8 9 8 8 9 8 9 8 8 9 9 9 2 
2 9 8 8 8 9 8 9 9 8 9 8 9 8 9 8 9 8 8 8 9 8 9 8 8 9 8 9 8 8 9 8 9 9 8 8 8 8 9 8 9 8 9 8 9 8 8 9 9 8 8 8 9 9 9 9 8 9 9 9 8 9 8 2 
2 8 8 9 8 8 9 9 8 8 8 9 8 9 9 9 8 8 8 9 8 8 9 8 9 8 8 8 9 9 9 8 8 8 9 8 8 9 9 8 8 8 9 9 9 8 9 9 8 9 8 8 8 9 9 9 8 9 8 8 8 9 9 2 
2 9 9 8 9 8 8 9 8 8 8 8 9 8 9 9 9 9 9 8 9 8 9 8 9 9 9 9 8 9 9 9 9 9 8 8 8 8 8 8 9 8 8 8 9 9 8 8 8 9 8 8 9 9 8 9 9 8 9 9 8 9 8 2 
2 9 9 8 8 8 9 8 9 9 8 9 8 9 9 8 9 9 8 8 8 9 9 8 9 9 9 9 8 8 9 9 9 9 9 8 9 8 8 8 8 8 8 9 8 8 8 9 8 9 8 8 8 9 8 8 9 8 9 9 8 9 9 2 
2 8 8 8 8 8 8 8 9 9 9 9 9 8 8 9 9 8 9 8 8 9 9 8 8 9 9 8 8 9 9 9 8 8 8 9 9 8 8 8 8 8 9 8 8 9 8 9 9 9 8 8 8 9 8 9 9 9 8 8 9 8 9 2 
2 9 9 8 9 9 8 8 8 9 9 9 9 9 9 8 9 8 8 8 8 8 8 9 8 8 8 8 8 9 9 8 9 9 8 9 9 9 8 8 8 9 9 8 9 8 8 9 8 8 8 9 8 8 8 9 8 9 9 8 8 8 9 2 
2 9 9 9 9 8 8 8 9 9 9 8 8 9 8 9 9 8 8 9 8 8 9 9 9 9 8 8 8 9 8 8 9 9 8 9 8 9 9 8 9 9 9 8 8 9 9 9 9 8 9 8 9 8 9 9 9 8 9 9 8 9 8 2 
2 9 8 9 9 9 8 9 9 9 8 8 9 9 9 9 9 9 9 9 9 8 9 9 6 9 9 6 8 7 8 9 6 9 9 8 7 8 10 9 8 8 8 9 9 9 9 9 9 9 8 8 9 9 8 8 9 8 8 9 9 9 9 2 
2 9 8 9 8 9 8 8 9 8 8 8 8 8 8 8 8 9 9 9 8 8 8 8 10 8 7 9 6 8 9 9 7 10 6 9 9 9 9 9 8 9 9 8 8 8 9 8 8 9 8 9 8 9 9 9 8 9 8 9 9 9 8 2 
2 8 8 9 9 8 8 9 8 9 8 8 8 8 9 8 8 8 8 8 8 9 8 9 9 8 8 7 6 6 9 6 8 8 8 8 8 8 9 9 8 9 8 8 9 9 9 9 8 8 9 8 8 8 8 9 9 9 9 8 9 9 9 2 
2 8 9 9 8 8 8 8 8 9 8 9 9 9 9 8 9 9 8 8 8 9 9 8 8 8 8 11 7 8 9 9 7 8 6 9 9 10 11 8 8 8 8 8 9 9 8 8 9 8 8 8 9 8 9 9 9 9 9 8 9 9 9 2 
2 8 8 8 9 9 9 9 9 8 9 8 9 9 9 9 9 8 8 8 9 9 8 9 7 6 8 8 6 8 8 7 6 8 7 8 11 8 8 8 9 8 8 8 8 8 8 8 9 9 8 8 9 9 9 9 8 9 9 8 9 8 8 2 
2 9 8 9 8 8 8 9 9 9 8 8 9 8 8 8 9 9 9 8 8 9 8 9 10 8 8 9 7 8 11 9 6 7 8 9 7 9 8 8 9 8 8 8 9 8 9 9 9 8 9 8 8 8 8 9 9 8 8 8 9 9 8 2 
2 9 9 9 8 8 8 9 9 9 8 8 9 9 9 9 9 8 8 9 9 9 8 8 10 9 8 9 9 11 11 10 10 9 8 10 8 6 10 9 8 8 9 8 8 9 8 8 9 8 8 9 9 8 8 8 9 8 8 9 8 8 8 2 
2 8 9 8 8 8 8 8 8 8 8 9 9 8 8 9 9 8 9 9 9 9 8 8 8 9 8 6 10 8 6 9 9 11 8 9 8 8 11 8 8 8 8 8 8 8 9 8 9 8 9 9 9 9 9 8 9 8 9 9 9 8 8 2 
2 8 9 8 8 8 8 8 8 9 9 8 9 9 9 9 9 9 9 9 9 8 9 8 9 8 8 11 11 6 6 10 11 10 11 9 7 7 9 9 9 9 8 8 8 9 8 8 8 9 9 9 9 8 9 8 9 8 8 9 8 9 8 2 
2 8 8 8 9 8 9 8 9 9 8 8 9 9 9 8 8 8 8 9 9 9 8 9 11 9 6 8 7 10 7 8 6 6 11 11 9 7 7 8 9 8 9 9 9 8 8 8 9 8 8 8 8 8 8 9 9 8 9 8 8 8 8 2 
2 8 8 8 9 8 8 9 9 9 8 9 8 8 9 8 8 9 9 8 9 9 8 8 8 8 9 9 11 9 11 9 7 10 11 7 6 9 7 9 8 9 9 9 8 9 8 9 9 9 8 8 9 8 9 8 8 8 8 8 8 8 8 2 
2 8 9 9 9 9 9 9 9 9 8 9 9 8 9 8 9 9 9 8 8 8 9 8 6 8 9 10 7 8 6 7 8 6 10 8 6 9 8 9 9 9 9 8 9 9 9 9 9 8 9 8 9 9 9 9 9 8 8 9 9 8 9 2 
2 8 9 8 8 8 9 8 8 9 8 9 9 8 8 9 8 8 8 9 8 9 9 8 8 9 6 9 8 10 8 8 11 8 6 7 8 7 7 8 9 9 8 9 8 8 9 8 8 8 9 9 8 9 9 9 9 8 9 9 9 9 9 2 
2 9 8 8 9 9 8 8 8 8 8 8 8 9 8 8 9 9 9 8 9 9 8 8 10 9 7 9 10 10 9 9 6 8 9 9 8 8 11 8 8 9 9 8 8 9 9 8 9 8 8 8 8 8 8 8 9 8 9 8 8 9 9 2 
2 9 8 8 8 9 8 8 8 9 8 8 8 8 9 9 9 9 8 9 8 8 8 9 10 11 6 6 6 7 10 8 7 7 6 6 7 9 6 8 8 9 8 8 8 9 9 8 8 8 8 8 8 8 8 8 9 8 9 8 9 8 8 2 
2 9 8 9 8 8 8 8 9 9 9 9 8 9 8 9 9 9 9 9 8 8 8 8 8 8 9 9 8 9 8 8 9 8 8 9 9 8 9 8 8 9 9 9 9 9 8 9 8 9 9 8 9 8 9 8 9 9 9 9 9 9 9 2 
2 8 9 9 9 9 9 8 9 8 9 8 8 9 8 8 8 9 9 8 8 8 9 9 8 9 9 9 9 9 9 8 9 9 9 9 9 9 8 9 9 8 8 9 8 9 8 9 9 9 9 9 9 9 8 8 8 8 8 9 9 9 9 2 
2 9 9 8 8 9 8 9 9 9 8 9 8 9 9 9 9 9 8 8 9 9 9 9 8 8 8 8 9 8 9 9 8 8 9 9 8 9 8 8 8 9 9 9 8 9 8 9 9 8 8 9 8 9 9 9 8 8 9 8 9 9 9 2 
2 8 8 8 9 9 9 8 9 8 9 8 8 9 8 8 9 8 9 8 8 8 8 8 9 8 9 8 9 9 9 8 9 8 8 9 8 9 8 9 9 8 8 8 9 8 9 8 8 8 8 9 8 8 9 8 9 8 9 9 8 9 8 2 
2 8 8 9 8 9 8 9 8 8 8 9 8 9 9 8 8 9 8 9 9 8 9 8 8 8 9 8 9 8 8 9 9 8 8 8 9 8 9 9 8 8 9 8 9 9 9 8 8 9 8 8 8 9 8 8 9 8 8 8 8 8 9 2 
2 8 8 9 8 8 9 9 8 8 9 8 8 8 9 8 8 9 9 8 9 9 9 9 9 8 8 9 8 8 9 8 8 9 9 9 9 9 9 9 8 9 9 8 9 9 8 9 8 9 8 9 8 8 9 9 9 8 9 8 9 9 8 2 
2 8 8 9 9 9 9 9 8 8 8 8 9 8 9 9 8 8 8 9 9 8 9 9 9 9 8 8 9 8 9 8 9 8 8 8 8 8 9 9 9 8 9 8 9 9 8 8 8 9 8 9 8 8 8 9 8 8 9 9 9 8 9 2 
2 8 8 9 8 8 8 8 8 8 8 9 8 9 9 9 9 9 8 9 8 8 9 9 8 9 9 9 9 9 9 8 9 8 8 9 9 8 8 9 8 8 8 8 8 8 8 9 9 9 8 8 9 8 8 9 9 9 8 8 8 9 8 2 
2 8 8 9 8 9 8 9 9 8 8 9 9 8 8 9 8 9 8 8 9 8 8 9 9 8 9 9 9 8 8 8 8 8 9 8 9 8 8 9 9 8 8 8 8 8 9 8 9 8 9 9 9 8 9 8 8 9 9 9 9 8 9 2 
2 8 9 9 8 9 8 9 9 9 9 8 9 8 8 8 9 8 8 8 8 8 8 9 8 9 9 8 9 8 9 9 9 8 8 9 9 8 8 9 8 9 8 9 8 9 8 9 8 9 9 8 8 9 8 9 8 9 8 9 9 9 8 2 
2 9 9 9 8 8 9 9 9 9 8 9 8 9 9 8 8 9 9 9 9 9 9 8 8 9 9 8 9 8 9 9 9 8 8 9 9 9 8 9 9 9 8 9 9 9 9 8 9 9 8 8 8 9 9 9 9 9 9 9 9 9 9 2 
2 8 9 9 8 8 9 8 8 8 8 9 8 9 8 8 8 9 9 9 8 9 9 8 9 8 9 9 8 8 9 8 8 9 9 9 8 8 8 9 8 9 8 9 8 9 9 9 9 8 8 9 8 8 8 8 9 9 9 9 8 8 9 2 
2 9 8 9 8 8 9 8 9 8 9 8 9 8 8 8 9 9 9 9 8 8 9 9 9 8 8 9 8 9 9 8 9 9 8 8 9 8 9 9 8 9 8 8 9 8 9 8 9 8 9 8 9 8 8 9 8 9 8 9 9 9 8 2 
2 9 9 9 9 9 9 9 9 9 8 9 9 9 9 8 8 9 9 9 8 9 9 8 9 8 8 9 8 9 9 8 9 8 8 9 8 9 8 9 9 8 9 9 9 9 9 9 8 8 8 9 9 8 9 8 9 9 8 8 8 8 9 2 
2 9 8 9 8 8 8 8 8 9 9 8 8 9 9 9 9 8 8 9 8 8 8 9 9 9 8 8 9 9 8 8 9 8 8 9 9 8 9 8 9 9 8 8 8 8 8 9 8 9 8 9 8 9 8 9 9 8 9 8 9 9 9 2 
2 8 9 8 9 9 9 8 9 9 8 9 8 8 9 8 9 9 9 9 8 8 8 9 8 9 8 8 9 9 9 8 9 9 9 9 8 8 8 8 8 8 9 9 9 9 8 9 8 8 9 9 8 9 8 9 9 8 9 8 9 9 8 2 
2 9 8 8 8 9 9 8 8 8 9 8 8 8 8 9 8 8 9 9 8 8 9 8 8 8 8 8 9 8 9 8 9 9 9 8 8 8 8 9 9 9 9 9 9 9 9 8 8 9 9 9 9 9 8 8 8 9 8 9 8 9 9 2 
2 9 9 8 9 8 8 9 8 9 9 8 8 9 8 8 9 8 8 8 8 9 8 8 9 8 9 8 8 8 8 9 9 8 8 9 8 8 8 8 9 9 9 8 9 8 8 9 8 9 9 8 9 8 8 8 9 8 8 9 9 9 8 2 
2 9 8 9 9 9 8 9 8 9 9 9 9 8 8 8 9 9 9 9 8 9 9 8 8 9 8 8 9 8 9 9 9 9 8 9 8 8 9 8 8 8 8 8 8 8 8 8 9 8 8 9 9 8 8 8 9 9 8 9 8 9 8 2 
2 8 9 8 9 9 9 9 9 8 9 8 9 8 9 8 9 9 9 8 8 8 9 8 8 9 9 9 8 8 9 9 8 8 8 9 8 8 8 8 8 8 9 8 8 8 9 8 8 8 8 8 8 8 9 8 9 8 8 9 8 9 9 2 
2 8 9 8 8 9 8 9 9 8 8 9 8 8 8 8 8 8 9 8 9 8 8 8 8 9 8 9 8 8 8 8 8 9 9 9 8 8 9 8 9 9 8 9 8 8 8 9 8 8 9 9 8 8 9 9 8 9 9 9 9 8 9 2 
2 8 8 8 9 8 8 8 8 8 9 9 8 8 9 9 9 8 8 8 9 9 8 9 9 9 8 8 8 8 8 9 9 9 8 8 8 9 9 8 9 8 9 8 8 9 8 9 9 8 9 9 9 8 8 8 8 8 8 9 8 9 8 2 
2 8 9 8 9 8 9 9 9 9 9 9 9 9 8 8 9 9 9 9 8 9 9 8 9 9 8 8 9 9 9 9 8 8 9 8 9 9 8 8 9 9 9 8 8 8 9 9 8 8 8 8 9 9 8 9 9 8 9 8 8 9 8 2 
2 8 8 8 8 8 9 9 8 8 8 9 9 8 9 9 9 8 9 8 9 9 8 8 9 8 9 9 8 9 9 9 9 8 9 8 8 8 9 8 9 9 8 8 8 9 9 9 9 8 8 8 8 8 9 8 9 9 9 8 9 9 8 2 
2 9 9 9 8 9 9 8 9 9 8 8 9 9 8 9 9 8 8 8 8 9 9 8 8 8 9 9 8 8 8 8 8 8 9 9 9 8 9 9 8 8 8 9 9 9 8 8 8 8 9 9 8 9 9 9 8 9 9 9 9 9 8 2 
2 8 8 9 8 9 9 8 8 8 8 9 9 9 8 9 8 8 9 8 9 8 8 9 9 8 9 8 8 9 8 9 9 8 9 9 9 8 9 9 8 9 9 8 9 9 8 8 9 8 8 8 9 9 8 8 9 9 9 8 9 9 9 2 
2 8 9 8 8 8 9 9 9 8 9 9 8 8 8 9 8 8 8 8 8 8 8 9 8 8 9 9 8 8 9 9 9 8 8 8 8 9 8 9 8 8 9 8 9 9 8 8 9 9 9 9 9 9 9 8 8 9 8 9 8 9 8 2 
2 9 8 8 9 9 8 8 9 9 8 9 9 8 8 8 8 9 8 8 8 9 8 8 9 8 9 9 9 8 8 8 9 9 8 9 9 9 8 9 8 9 9 9 9 9 8 9 8 9 9 9 8 8 8 9 8 9 8 8 8 9 8 2 
2 2 2 2 2 2 2 2 2 2 2 2 2 2 2 2 2 2 2 2 2 2 2 2 2 2 2 2 2 2 2 2 2 2 2 2 2 2 2 2 2 2 2 2 2 2 2 2 2 2 2 2 2 2 2 2 2 2 2 2 2 2 2 2 
