2 2 2 2 2 2 2 2 2 2 2 2 2 2 2 2 2 2 2 2 2 2 2 2 2 2 2 2 2 2 2 2 2 2 2 2 2 2 2 2 2 2 2 2 2 2 2 2 2 2 2 2 2 2 2 2 2 2 2 2 2 2 2 2 
2 9 9 9 9 8 8 8 9 9 9 8 8 9 9 8 9 8 9 9 9 8 9 8 8 8 9 8 8 9 9 9 9 8 8 9 9 8 9 9 9 8 8 9 9 8 9 8 8 8 9 9 8 9 8 8 9 8 9 9 8 8 9 2 
2 9 8 9 8 9 9 8 9 8 9 8 8 9 9 9 9 8 9 9 9 9 8 8 8 9 8 8 9 9 8 8 9 8 8 8 8 8 8 8 9 8 9 9 9 9 8 8 8 8 8 9 8 8 9 8 8 8 9 9 9 8 8 2 
2 9 9 9 8 9 9 9 9 9 9 9 9 9 8 8 8 8 9 8 9 9 9 9 8 8 9 9 8 9 8 8 8 8 8 8 8 9 9 9 8 8 8 8 8 9 8 9 9 9 8 8 8 8 8 8 9 8 8 8 9 9 8 2 
2 8 9 8 8 9 8 9 8 8 9 8 8 9 9 9 9 8 8 9 9 8 9 9 8 8 9 9 8 9 9 8 8 9 9 8 8 9 8 9 8 9 8 8 9 8 9 9 9 9 8 8 8 9 9 9 8 8 9 9 8 8 9 2 
2 9 8 8 9 9 9 9 9 9 8 8 9 9 8 8 9 9 9 9 9 8 9 8 8 8 9 8 8 9 9 8 8 9 8 9 8 9 8 9 8 8 8 9 8 8 9 8 9 9 8 8 8 8 9 8 8 8 8 9 9 8 9 2 
2 9 8 9 8 8 9 8 9 8 8 8 9 8 9 8 8 8 8 9 8 9 9 9 9 8 9 8 9 8 9 9 8 9 8 8 8 8 8 9 8 8 9 9 8 9 8 8 8 8 9 9 9 9 9 9 9 9 9 8 8 8 8 2 
2 9 8 8 8 9 9 8 8 8 9 8 9 9 9 8 9 8 9 8 8 8 9 9 9 8 9 9 8 8 9 9 9 9 8 9 8 9 8 9 9 9 8 8 9 8 8 8 9 8 8 9 8 9 9 8 9 9 9 9 8 9 9 2 
2 9 9 9 8 9 9 8 9 9 9 9 8 8 8 9 8 8 8 8 8 9 9 9 8 9 9 8 9 8 8 8 9 8 8 8 8 9 9 9 8 9 9 9 9 8 8 9 8 9 8 9 9 9 9 9 9 9 8 8 9 8 8 2 
2 8 9 9 8 8 8 8 8 9 8 9 9 8 9 8 8 9 8 8 8 9 8 9 9 9 9 9 8 9 8 8 9 9 9 9 9 9 9 9 9 8 9 9 9 9 8 8 9 9 9 8 8 8 9 9 8 9 9 9 8 8 9 2 
2 9 8 9 9 9 8 8 8 9 8 8 8 9 9 9 9 8 9 9 9 9 9 9 8 8 9 8 8 8 8 8 8 8 9 8 9 9 8 8 8 8 8 8 9 8 8 9 8 9 9 9 9 9 9 9 8 9 8 9 8 8 8 2 
2 9 9 9 9 9 8 8 8 8 8 8 8 8 8 9 8 8 9 8 9 8 8 8 9 9 8 9 9 8 9 8 8 8 8 9 9 9 9 9 9 8 9 9 8 9 8 9 9 8 9 8 8 8 8 9 8 9 8 8 8 9 8 2 
2 9 8 8 8 9 8 8 9 8 8 8 9 8 8 8 8 9 9 8 9 8 9 9 8 9 8 8 9 8 9 9 9 9 8 8 9 9 8 8 8 9 8 9 9 8 9 8 9 9 9 8 8 8 9 9 8 8 9 8 9 8 9 2 
2 9 9 9 9 9 9 8 8 8 8 8 8 9 8 9 9 8 9 9 8 9 9 8 9 8 9 9 8 9 8 8 9 8 8 9 8 9 9 9 8 8 8 8 8 8 9 8 8 8 9 8 8 8 9 9 9 8 9 8 9 9 8 2 
2 8 8 8 9 8 8 8 9 8 8 9 9 9 8 9 8 9 8 8 8 9 9 8 9 9 8 8 9 8 8 9 8 8 8 9 8 8 8 9 8 8 8 9 9 9 8 8 9 9 9 9 8 9 9 9 8 8 8 8 8 8 8 2 
2 9 9 8 8 9 8 8 9 8 8 9 8 9 9 8 8 8 8 9 9 9 8 9 8 9 9 8 8 9 8 9 8 9 9 8 9 9 8 8 9 8 8 8 9 9 9 9 8 9 8 9 8 9 9 9 8 9 8 9 8 8 8 2 
2 9 9 9 8 9 8 9 9 8 8 8 8 8 9 9 8 8 8 8 9 8 8 8 8 8 9 9 9 9 8 8 9 8 8 9 8 8 9 9 8 9 8 8 9 9 9 9 8 9 9 9 9 8 9 9 9 8 8 8 8 8 9 2 
2 8 8 9 8 8 8 9 8 8 8 9 8 8 9 8 8 8 8 8 8 9 8 9 9 8 9 9 9 8 8 8 9 8 8 8 8 8 8 9 8 9 8 9 8 9 8 9 8 8 8 8 8 9 9 9 9 8 8 8 9 8 8 2 
2 9 8 8 9 8 8 9 9 9 9 8 9 8 9 8 9 8 9 9 9 9 8 8 8 9 9 9 8 9 8 9 9 8 9 8 8 9 8 8 9 8 8 8 9 8 8 9 9 8 8 9 9 9 8 8 9 9 8 8 9 8 8 2 
2 8 9 9 9 8 8 9 9 9 9 9 9 8 8 9 9 9 8 8 8 9 9 9 9 8 8 8 8 9 9 8 9 8 8 9 9 9 9 8 8 8 9 9 8 8 8 8 9 9 9 8 9 8 9 8 8 8 8 8 9 9 8 2 
2 9 9 8 9 8 8 9 9 8 9 4 1 3 4 1 3 8 6 3 6 2 9 1 3 8 8 9 8 9 8 8 8 8 9 8 8 9 9 8 9 9 8 9 9 9 8 9 8 8 9 9 8 9 8 8 8 9 8 9 8 9 9 2 
2 9 9 8 8 8 8 9 9 8 8 3 8 3 2 5 1 9 4 8 2 4 4 6 4 9 9 8 8 9 8 8 8 9 9 8 9 9 8 8 9 8 9 9 8 8 9 9 9 8 9 8 9 9 8 8 9 9 8 8 9 8 9 2 
2 8 9 8 8 8 8 8 9 8 8 4 8 2 1 2 2 8 9 2 6 3 5 6 3 1 8 8 9 9 8 9 9 8 8 8 8 8 9 9 9 8 9 9 9 8 8 8 8 9 9 9 9 9 9 9 8 9 8 8 9 8 9 2 
2 8 9 9 8 9 8 9 8 8 8 1 5 6 2 2 3 9 9 3 8 9 2 1 2 9 8 9 8 8 8 8 8 8 9 8 8 8 9 9 8 8 8 8 8 8 9 9 9 9 9 8 9 8 8 9 8 8 8 8 9 8 8 2 
2 8 9 9 8 8 8 8 8 9 9 1 9 4 4 4 4 4 4 6 3 3 4 5 8 4 8 9 9 8 8 9 8 8 8 9 9 9 8 8 8 9 8 8 9 9 9 9 8 8 8 9 8 8 8 8 9 9 9 8 8 9 8 2 
2 8 8 9 9 8 8 8 9 8 8 8 6 4 2 4 4 6 3 5 6 3 1 3 2 9 8 8 9 8 8 8 8 9 9 9 9 8 9 8 8 8 9 9 9 8 8 8 9 8 9 8 9 8 9 8 9 9 8 9 8 9 8 2 
2 9 8 8 8 8 8 9 9 9 9 9 2 8 3 2 3 1 2 4 3 4 9 1 1 2 8 8 8 9 9 9 8 8 8 9 8 9 8 8 9 9 8 9 8 8 8 8 9 8 8 9 9 8 8 9 9 8 9 8 8 9 8 2 
2 8 9 8 9 8 8 8 9 8 8 8 9 1 4 1 1 6 5 1 4 3 9 4 6 4 8 9 9 8 9 9 9 9 9 9 9 8 8 8 8 8 8 9 8 9 8 8 8 8 9 9 8 8 8 9 9 8 9 8 8 9 9 2 
2 9 8 8 9 8 8 8 8 9 9 5 8 6 2 5 6 6 6 5 1 5 5 6 9 8 9 9 9 9 9 8 8 9 8 9 9 8 9 9 9 8 9 8 8 9 8 9 8 8 9 8 8 9 8 9 8 8 9 9 8 8 9 2 
2 8 8 9 9 8 8 9 9 9 8 2 3 6 4 5 6 4 4 1 6 2 6 3 6 9 8 9 8 8 8 8 9 8 9 8 8 8 8 8 8 8 8 8 8 9 9 8 9 9 8 8 8 8 9 9 9 8 8 8 9 9 9 2 
2 9 9 8 8 8 9 9 9 8 9 5 5 9 8 6 2 4 2 5 2 5 6 2 8 4 8 9 9 9 8 9 8 8 9 8 9 8 9 8 8 9 8 8 8 9 9 9 8 8 8 8 8 9 8 9 8 9 9 8 8 9 8 2 
2 9 9 9 8 9 8 8 8 8 9 5 2 4 4 6 8 9 1 3 8 2 8 3 8 2 8 9 9 8 9 8 8 9 8 9 9 8 9 8 8 9 8 9 9 9 8 8 8 8 9 9 8 9 8 9 9 8 9 9 8 9 8 2 
2 8 9 8 8 9 9 8 9 8 8 4 9 1 9 9 3 5 5 3 9 3 9 2 4 2 9 9 9 8 8 8 9 9 9 9 8 9 9 8 8 9 8 8 8 9 9 9 9 9 8 8 8 8 9 9 8 9 9 9 8 8 9 2 
2 8 8 8 9 9 9 9 8 8 9 8 9 2 3 9 1 5 3 9 1 6 6 8 8 5 9 8 8 8 8 8 8 9 9 9 8 8 8 9 8 9 8 8 8 8 9 9 9 9 9 9 8 8 9 8 9 9 8 9 9 9 9 2 
2 8 8 9 8 8 8 9 8 9 8 8 8 5 8 8 4 9 1 9 2 4 9 3 3 9 9 8 9 9 8 9 8 8 9 8 9 8 9 8 8 8 9 9 8 8 8 8 8 9 8 8 9 8 9 8 9 9 8 8 9 8 8 2 
2 8 8 9 8 9 9 8 9 8 8 8 9 9 8 8 9 8 9 8 9 9 8 8 9 9 9 8 8 8 8 8 9 9 8 8 8 9 9 8 8 9 8 9 9 9 9 8 9 8 9 9 9 8 9 8 8 8 9 8 9 8 8 2 
2 9 8 9 8 9 8 8 8 9 8 9 9 8 9 8 8 9 8 9 8 9 8 9 9 9 9 9 8 8 8 9 8 8 8 9 9 9 9 8 9 9 9 9 8 9 9 8 8 9 8 9 9 8 9 8 8 8 9 9 9 8 8 2 
2 8 9 9 9 8 8 8 9 8 8 9 9 9 8 8 9 9 9 8 8 8 9 9 9 9 8 9 8 9 8 8 8 8 8 8 8 8 8 9 8 8 8 9 9 9 9 8 9 9 9 9 9 9 8 8 9 8 9 8 9 9 8 2 
2 9 9 8 8 9 9 9 9 8 9 9 9 9 9 8 9 8 8 9 8 9 8 8 9 9 9 8 8 8 8 9 8 8 8 9 8 8 8 8 9 8 9 9 8 8 8 8 9 8 8 8 8 8 8 9 8 9 8 8 8 8 8 2 
2 9 8 8 9 9 9 8 8 8 9 8 9 9 8 9 9 8 9 8 9 8 9 8 9 9 9 8 8 9 8 8 8 9 8 8 9 9 8 9 9 9 8 8 9 9 8 9 8 9 9 9 9 8 9 9 9 8 9 9 8 9 9 2 
2 9 9 8 9 8 9 8 9 8 8 8 9 8 9 9 9 9 9 9 8 8 8 9 9 8 9 9 9 9 9 8 8 9 9 8 9 8 9 8 9 8 9 8 8 8 8 8 8 8 8 9 8 9 9 8 8 8 9 8 8 9 8 2 
2 8 8 8 8 8 8 9 8 9 8 9 9 9 9 9 8 9 8 8 8 9 9 8 8 8 8 8 9 9 9 9 9 8 8 8 9 8 9 9 9 8 8 8 9 8 9 8 9 9 9 8 8 9 8 9 8 8 9 9 8 9 9 2 
2 9 9 8 8 9 8 9 9 8 9 9 8 9 8 8 8 8 8 8 9 9 9 8 8 9 9 9 8 9 8 9 9 9 9 9 8 9 8 8 9 9 9 9 8 8 8 8 9 9 8 9 8 8 9 8 9 9 9 9 9 8 9 2 
2 9 9 8 9 9 8 8 8 8 9 9 9 9 8 8 9 9 8 9 9 8 8 9 8 9 9 8 9 8 9 9 9 8 9 9 9 8 8 9 9 9 8 9 9 8 8 9 8 8 8 9 9 8 8 8 9 8 9 9 8 8 8 2 
2 8 8 8 9 9 9 9 8 9 8 8 8 9 9 8 9 8 9 9 9 9 8 8 9 8 8 8 9 9 8 9 9 8 9 8 9 8 8 9 8 8 8 9 8 8 9 9 9 8 8 9 8 8 9 9 8 9 8 9 8 8 8 2 
2 9 8 9 8 9 9 9 8 8 9 8 9 8 9 9 9 8 8 9 8 8 8 9 8 9 8 8 8 9 8 8 8 9 8 9 9 8 9 8 9 8 9 9 9 9 9 8 8 8 8 9 9 8 8 8 9 9 8 8 9 8 9 2 
2 9 9 9 9 8 8 9 9 9 8 9 9 8 8 9 8 9 9 9 8 8 9 8 8 9 9 8 9 9 8 8 9 9 9 8 8 8 8 8 8 8 9 8 9 9 8 8 8 9 8 9 8 8 9 8 9 9 8 9 9 8 9 2 
2 9 9 8 9 8 9 9 8 9 9 8 8 8 9 8 8 9 9 9 8 8 9 9 8 9 9 8 8 9 8 9 8 9 9 9 8 9 8 9 9 9 8 9 8 8 9 8 8 8 9 8 9 9 8 9 8 9 9 8 9 9 8 2 
2 9 9 9 9 9 8 9 9 8 8 8 8 9 9 9 8 8 9 8 8 8 9 9 9 9 9 9 8 9 8 9 9 9 8 9 8 9 9 9 8 8 9 9 8 9 8 8 9 9 8 9 8 8 8 9 8 8 9 9 9 9 9 2 
2 9 8 8 9 9 8 9 9 9 9 9 8 9 9 9 9 9 9 9 8 9 9 9 8 9 8 8 9 9 9 8 9 8 9 9 8 9 9 8 8 8 8 9 8 9 9 8 8 8 9 9 8 8 8 8 9 9 9 8 9 9 9 2 
2 9 8 9 8 9 8 9 8 9 8 8 9 8 8 9 8 9 9 8 8 8 9 9 8 8 9 8 9 9 9 8 9 8 8 9 8 9 8 8 9 9 8 9 8 8 8 8 9 9 9 9 9 9 9 9 8 8 8 8 8 9 9 2 
2 8 9 8 8 9 9 8 9 9 8 9 9 9 9 8 9 8 9 9 9 8 8 8 8 8 8 8 8 9 8 8 8 8 9 8 9 9 9 9 8 8 9 8 8 9 9 9 9 8 8 8 8 9 8 9 9 9 8 8 8 9 9 2 
2 9 8 8 8 8 8 8 9 8 8 9 9 9 8 9 9 8 9 8 9 9 8 9 8 8 9 9 9 8 9 8 8 8 9 9 8 8 9 8 8 8 8 9 8 8 9 9 8 8 8 8 9 9 9 9 9 9 9 9 8 9 9 2 
2 8 8 8 8 9 8 8 8 8 9 8 9 8 8 8 9 8 8 9 9 8 8 8 8 8 8 8 9 9 9 8 9 8 9 9 9 9 9 8 8 9 8 9 9 9 8 8 9 9 9 9 8 9 8 8 8 9 9 9 9 9 8 2 
2 9 9 8 9 8 9 9 9 9 9 9 8 8 9 9 8 8 8 8 8 8 9 9 8 8 9 9 9 8 9 8 9 9 9 9 8 8 8 9 9 9 9 9 9 8 9 8 8 9 9 8 9 9 8 8 9 9 9 8 9 9 8 2 
2 9 8 9 9 8 9 9 9 9 8 8 8 8 9 9 8 8 8 8 9 9 9 8 8 9 9 8 9 9 9 9 8 9 8 9 9 8 8 8 8 8 8 8 8 9 8 8 9 9 9 8 9 9 8 8 9 8 9 8 9 8 9 2 
2 8 8 8 8 9 9 9 9 9 8 9 8 9 8 8 9 8 9 8 9 8 8 8 8 8 9 8 8 9 8 9 9 9 9 9 8 8 8 9 9 9 9 8 9 9 8 9 8 9 8 8 9 8 8 9 9 9 9 9 9 9 9 2 
2 9 9 9 9 9 8 8 8 9 8 9 9 9 8 9 8 9 8 9 9 8 9 9 8 8 9 8 9 9 8 9 8 8 8 9 9 8 8 8 9 9 9 8 8 8 9 9 8 9 8 8 9 8 8 9 8 8 9 9 8 9 9 2 
2 9 8 8 8 9 8 8 9 9 9 8 8 9 9 8 8 8 9 8 9 9 8 9 9 9 9 8 8 8 9 8 9 8 9 9 9 9 8 8 9 8 9 8 8 8 8 8 8 9 8 8 9 9 8 9 8 9 8 9 8 8 8 2 
2 9 8 8 8 8 9 9 8 8 8 8 8 8 8 9 9 9 8 8 9 9 9 8 9 9 9 8 8 8 9 8 9 9 9 8 8 9 9 9 9 9 9 8 9 8 8 9 9 9 8 8 9 9 9 8 8 9 9 8 8 8 9 2 
2 8 8 8 8 9 9 8 9 9 8 8 8 8 8 9 9 9 8 8 9 8 8 9 9 8 8 9 9 8 8 9 9 9 9 8 8 9 9 8 8 8 9 9 9 9 8 8 8 8 8 8 9 9 8 8 8 9 8 8 8 8 8 2 
2 9 8 9 9 8 9 9 9 8 9 8 8 8 8 8 9 9 9 8 9 9 8 8 8 8 8 8 8 9 8 9 9 8 9 9 9 8 9 9 9 8 9 8 8 9 8 9 9 8 9 8 8 8 8 8 8 9 8 9 9 9 9 2 
2 8 9 8 8 8 9 8 9 8 8 9 9 9 9 9 8 8 9 8 8 8 8 9 9 8 9 9 8 8 9 9 8 9 8 8 9 9 9 9 8 8 8 9 8 9 8 9 8 9 9 8 9 9 8 9 8 9 8 8 8 9 8 2 
2 2 2 2 2 2 2 2 2 2 2 2 2 2 2 2 2 2 2 2 2 2 2 2 2 2 2 2 2 2 2 2 2 2 2 2 2 2 2 2 2 2 2 2 2 2 2 2 2 2 2 2 2 2 2 2 2 2 2 2 2 2 2 2 
