2 2 2 2 2 2 2 2 2 2 2 2 2 2 2 2 2 2 2 2 2 2 2 2 2 2 2 2 2 2 2 2 2 2 2 2 2 2 2 2 2 2 2 2 2 2 2 2 2 2 2 2 2 2 2 2 2 2 2 2 2 2 2 2 
2 8 9 9 8 9 8 8 9 8 8 8 8 8 9 9 9 8 8 9 9 9 9 9 8 8 9 9 9 9 9 8 9 9 8 9 8 9 9 9 8 8 9 9 9 9 9 9 9 8 8 8 8 9 9 8 8 9 8 8 8 8 9 2 
2 8 9 9 9 9 9 8 8 9 8 9 8 9 8 9 9 8 9 8 8 9 8 9 9 8 9 8 8 9 9 8 9 8 9 8 8 8 8 9 9 9 8 9 9 8 8 8 9 9 9 9 9 8 8 9 8 8 9 9 9 8 9 2 
2 9 9 9 9 8 8 9 8 9 9 8 8 8 9 9 8 9 9 8 8 8 8 8 9 8 9 9 8 9 8 8 8 9 9 8 9 9 8 9 9 9 9 8 9 9 9 9 8 9 9 9 8 9 8 8 9 8 8 8 8 9 8 2 
2 8 9 8 9 9 8 8 8 9 9 8 8 8 8 9 8 8 8 8 9 9 9 8 9 9 8 9 9 8 8 9 8 9 9 8 9 8 9 9 8 8 8 8 8 8 8 9 9 8 9 9 8 9 9 8 9 8 9 9 9 8 9 2 
2 9 8 9 8 8 8 9 9 8 8 8 9 8 8 9 9 9 9 8 9 8 8 8 9 9 8 9 8 9 8 8 8 8 8 9 8 9 8 9 8 8 9 9 8 8 9 8 9 9 8 8 9 8 9 9 8 9 8 8 8 8 8 2 
2 8 8 9 9 9 8 9 8 8 8 9 8 9 9 8 8 9 8 8 8 8 8 8 8 8 8 9 9 8 8 8 9 8 9 8 9 9 9 9 8 8 8 9 8 9 8 8 9 8 8 9 8 8 9 8 8 8 8 8 9 9 8 2 
2 9 8 8 9 9 9 8 9 9 8 8 9 9 9 8 9 8 9 9 8 9 9 8 9 8 9 9 9 9 9 8 8 8 9 8 9 8 9 9 8 9 8 8 8 8 9 9 8 9 9 8 8 9 8 8 9 8 8 9 9 9 9 2 
2 8 8 8 8 9 9 9 8 8 8 9 9 8 9 9 8 9 8 8 8 9 9 9 8 9 8 9 9 9 8 8 9 9 9 8 9 9 9 9 9 9 8 9 9 9 9 9 9 9 8 9 8 8 9 8 8 9 9 8 8 8 9 2 
2 8 9 8 8 8 8 8 8 8 9 8 9 8 8 9 9 9 8 8 8 9 9 9 9 9 8 8 8 8 9 8 8 9 8 9 9 8 8 9 8 9 9 8 8 9 8 8 8 9 9 8 9 9 9 9 8 8 8 9 9 8 8 2 
2 9 8 8 9 8 8 8 8 8 8 8 8 9 9 9 8 9 8 9 8 8 8 9 8 8 8 8 8 9 9 9 8 8 9 9 9 9 9 9 9 8 9 8 8 8 8 8 8 8 9 8 9 8 8 8 8 8 8 8 8 8 9 2 
2 8 9 9 8 8 9 8 8 9 9 9 8 9 8 8 8 9 9 9 8 8 9 8 9 9 9 8 8 9 8 9 8 8 8 9 8 8 8 9 8 9 8 9 9 9 8 9 9 8 8 8 9 8 9 9 8 9 9 8 8 9 8 2 
2 8 8 8 9 9 8 9 8 8 8 9 9 9 8 9 9 8 8 8 8 8 9 8 8 9 8 9 8 8 8 9 9 9 9 9 9 9 9 9 9 9 8 9 9 9 9 8 8 8 8 8 8 9 9 8 9 8 8 9 8 8 9 2 
2 9 8 9 9 9 9 9 8 8 8 8 9 9 8 8 8 8 8 9 9 8 9 9 8 9 9 8 8 9 8 8 8 9 8 8 8 9 8 9 9 8 8 9 8 8 9 9 9 8 8 8 8 8 9 8 8 8 9 8 8 9 9 2 
2 9 9 9 8 9 9 9 9 8 9 9 8 9 8 9 9 8 8 8 9 9 9 8 8 8 9 8 9 9 9 8 8 8 9 9 8 8 8 8 8 8 8 8 8 9 9 8 8 9 8 8 9 9 8 8 8 8 9 8 9 9 8 2 
2 9 9 8 9 8 8 9 9 9 8 9 9 9 8 8 9 8 8 9 8 8 9 8 8 8 8 8 8 8 8 8 9 9 9 8 8 8 9 8 9 9 8 9 9 8 8 9 9 9 8 9 8 9 8 8 9 8 9 9 9 9 9 2 
2 9 8 9 8 8 8 9 8 9 8 9 9 9 9 9 9 8 9 8 8 8 8 9 8 8 8 8 8 9 8 8 9 8 9 8 9 8 8 8 9 8 8 8 9 8 8 8 8 8 9 9 9 9 8 8 8 9 8 9 9 8 8 2 
2 9 9 9 9 9 9 8 8 8 8 9 9 8 9 8 8 8 9 8 8 8 8 8 8 9 9 9 9 8 9 9 8 9 8 9 8 9 8 8 8 9 8 8 9 9 9 8 8 8 9 9 8 8 9 8 9 9 8 9 9 8 8 2 
2 8 9 8 9 8 9 8 9 9 8 9 9 8 8 9 8 8 9 8 9 8 8 8 9 8 8 9 8 9 9 8 9 8 9 8 8 9 9 9 8 9 8 9 9 9 8 8 8 9 8 8 8 9 9 9 8 8 9 9 9 9 9 2 
2 8 9 8 9 8 8 9 9 9 8 8 9 8 8 2 9 0 9 1 3 8 2 1 9 8 5 4 8 8 9 9 9 9 8 9 9 8 8 8 8 9 9 8 8 8 8 9 8 8 9 9 9 9 8 8 9 9 8 9 8 8 8 2 
2 8 9 8 8 8 8 8 8 8 9 8 8 5 4 8 3 2 4 4 1 1 1 8 3 9 2 3 9 9 8 8 8 8 9 8 8 9 8 8 9 8 9 8 8 9 9 9 9 8 9 9 8 9 8 8 9 8 8 9 8 8 9 2 
2 8 9 9 9 9 8 8 9 9 8 8 8 5 2 2 8 0 5 4 9 9 8 4 1 2 9 8 9 9 8 9 9 9 8 9 9 8 8 8 9 9 8 9 9 9 8 9 9 9 9 8 9 9 8 9 8 8 8 8 8 9 8 2 
2 9 8 9 9 8 9 8 9 9 9 9 8 9 1 5 4 4 5 5 1 0 9 4 3 8 0 9 9 8 8 9 8 8 9 8 9 8 8 9 8 9 8 8 8 8 8 8 9 9 8 9 8 9 8 9 8 8 8 9 9 8 9 2 
2 8 9 8 9 9 8 8 9 9 9 9 9 9 3 0 1 3 3 2 2 1 2 5 2 5 2 5 9 9 9 8 8 8 8 8 8 8 8 8 8 9 8 8 8 9 9 9 9 9 8 9 8 8 8 9 8 8 8 9 8 8 8 2 
2 9 9 8 8 9 9 8 9 9 9 9 9 9 5 5 3 1 0 8 1 1 3 4 2 1 1 0 8 8 8 8 9 9 8 9 9 9 8 9 9 9 8 9 8 9 8 9 8 8 8 9 9 9 8 9 9 8 9 8 9 9 8 2 
2 9 8 9 9 9 8 9 9 8 8 8 9 4 1 9 3 0 4 5 3 2 5 2 8 4 3 9 9 9 9 8 8 9 9 9 8 9 9 9 9 8 8 8 8 8 8 9 8 9 9 8 9 9 8 8 8 9 9 9 8 8 9 2 
2 8 9 8 9 8 8 8 8 8 8 8 8 0 0 1 9 3 5 5 1 3 5 5 5 8 8 0 9 8 8 8 9 8 8 8 9 9 8 9 9 8 8 9 9 9 8 9 9 9 9 8 9 9 8 9 9 9 8 9 9 9 9 2 
2 8 8 9 8 9 9 9 8 8 8 8 9 0 8 4 4 5 4 3 1 0 0 2 8 1 9 2 9 8 8 8 9 8 8 9 8 8 9 9 8 9 8 9 8 8 9 9 8 8 9 9 9 9 8 8 9 8 9 9 9 9 8 2 
2 9 9 8 9 8 9 9 9 8 8 8 8 9 4 9 1 5 1 5 0 0 2 4 8 8 0 1 8 8 8 8 8 8 8 9 9 9 9 8 8 8 9 9 9 8 8 8 9 8 8 9 8 8 9 8 8 9 9 8 8 9 8 2 
2 8 9 9 9 9 8 9 8 8 8 8 8 5 1 9 2 4 1 1 4 2 4 1 9 1 9 1 9 8 9 9 9 9 9 9 8 9 9 9 9 8 8 9 9 9 9 9 9 9 8 8 8 8 8 8 9 8 8 8 9 8 9 2 
2 8 9 9 8 8 9 9 9 9 9 9 8 9 8 3 4 0 1 0 9 2 4 1 8 4 9 8 8 9 9 8 8 9 8 8 8 8 8 9 8 9 8 8 8 9 8 9 8 8 8 8 9 9 9 9 8 8 9 9 8 9 8 2 
2 9 8 8 8 9 9 8 9 9 8 9 8 5 3 1 9 3 2 8 9 0 4 0 9 2 1 1 8 8 8 9 9 8 9 8 9 8 9 8 8 9 8 8 8 9 9 9 9 8 8 9 9 8 9 9 9 8 9 9 9 8 8 2 
2 9 9 9 9 8 8 8 8 9 9 8 9 1 8 5 8 2 4 4 1 0 5 0 5 5 1 5 8 8 8 8 9 8 9 9 9 8 8 9 8 8 8 8 8 9 9 8 8 9 9 8 9 8 9 8 8 9 8 9 9 8 9 2 
2 8 8 8 9 8 9 9 8 9 9 9 8 4 1 3 8 8 0 2 5 3 9 8 4 4 3 3 9 9 9 9 9 9 8 9 8 9 8 8 8 8 8 8 8 9 8 9 9 9 8 9 9 8 9 9 9 8 9 9 8 9 9 2 
2 9 9 9 9 8 9 8 9 8 8 8 8 9 9 9 8 9 8 9 9 8 9 8 8 9 8 8 8 9 9 9 8 8 9 8 9 9 8 9 9 8 8 8 8 8 9 9 9 9 8 9 8 9 8 9 8 9 9 8 8 8 9 2 
2 8 9 8 8 8 8 9 8 8 9 9 9 8 8 8 8 9 9 8 9 9 9 8 9 8 9 9 8 8 9 9 8 8 8 9 9 8 8 9 9 9 9 8 8 9 9 8 9 9 8 9 9 9 8 8 9 8 9 8 8 8 8 2 
2 8 8 8 8 8 8 8 9 9 8 8 9 8 9 9 8 9 9 8 9 9 9 9 9 8 8 8 9 8 8 8 8 8 8 8 9 8 9 8 9 9 9 8 9 8 9 8 8 9 8 8 8 9 9 9 8 8 8 9 8 9 9 2 
2 8 9 9 8 9 8 9 9 8 9 8 9 8 9 8 9 9 9 8 9 8 8 8 8 8 8 9 8 9 8 8 8 9 8 8 9 9 8 9 8 9 8 9 9 8 8 8 9 8 9 9 9 9 9 9 8 8 8 8 9 8 8 2 
2 9 8 8 8 8 9 8 8 9 8 8 9 8 8 9 9 8 9 9 8 9 9 8 9 8 9 9 9 8 9 9 8 9 9 8 8 8 9 9 8 8 8 8 9 8 8 9 8 9 9 8 9 8 8 8 8 8 9 9 9 9 9 2 
2 9 9 8 9 9 8 8 9 8 8 9 9 8 9 8 9 8 9 9 8 9 9 9 8 9 9 9 8 9 9 9 8 8 9 8 8 9 9 9 9 8 9 9 8 9 8 8 9 8 8 8 9 8 8 9 9 9 9 9 8 9 9 2 
2 9 9 8 8 9 9 9 8 8 8 9 8 9 8 8 8 8 8 8 8 8 8 9 9 9 9 8 9 8 9 9 9 8 9 8 8 9 9 9 8 8 8 8 9 8 9 8 9 8 9 8 8 9 8 8 8 9 8 9 8 8 9 2 
2 9 9 9 9 9 9 8 9 9 9 8 8 9 9 8 8 8 9 9 9 8 8 8 9 9 9 8 8 9 9 9 9 9 9 9 9 8 9 8 9 9 9 9 9 9 8 9 9 8 8 8 9 9 9 8 9 9 9 9 9 8 9 2 
2 8 8 8 9 8 8 8 8 8 8 9 9 8 9 8 8 9 9 8 8 8 8 9 8 9 9 8 9 9 9 9 9 9 8 8 8 9 9 8 9 8 9 9 9 8 8 8 8 8 8 9 8 8 8 8 8 9 9 8 8 9 9 2 
2 9 8 8 8 9 9 9 9 9 8 9 8 8 9 8 9 8 8 8 8 8 8 8 9 9 9 9 8 9 8 8 9 8 8 9 9 9 9 8 9 9 8 9 9 9 8 8 8 8 8 9 9 8 9 8 8 9 9 9 8 8 8 2 
2 9 9 8 8 9 8 8 9 9 9 9 9 8 8 9 8 9 9 9 9 9 9 8 8 8 8 9 9 9 8 9 9 8 9 8 9 9 9 8 9 8 9 8 8 9 8 8 8 8 9 8 8 8 9 8 9 8 9 9 8 9 8 2 
2 8 8 9 9 9 9 8 8 9 9 8 9 8 9 9 8 9 9 9 9 9 9 8 9 8 9 8 9 9 9 8 8 8 9 9 9 8 8 9 8 8 8 9 9 8 9 9 9 8 9 9 9 9 9 8 8 8 8 8 9 9 9 2 
2 8 8 8 9 9 9 8 9 9 8 9 8 9 8 8 9 9 9 9 9 8 9 9 8 8 9 9 9 8 8 9 8 8 8 8 9 8 8 9 8 8 9 8 8 9 8 8 8 9 9 8 9 8 9 9 9 9 8 8 9 9 9 2 
2 8 9 8 8 9 8 9 8 8 9 8 9 9 8 8 9 8 8 9 8 9 9 9 9 8 9 8 9 8 9 9 9 8 9 9 8 8 9 8 8 8 8 8 9 9 8 9 9 8 8 8 9 9 9 8 9 9 8 9 8 9 8 2 
2 9 8 8 8 9 8 9 9 8 8 8 8 9 9 8 8 8 8 9 8 8 9 8 9 9 9 8 8 8 9 9 9 8 9 9 8 8 8 9 9 8 8 9 8 8 8 9 9 9 8 9 8 8 8 9 8 9 9 9 9 8 9 2 
2 9 9 8 9 8 8 9 8 8 8 9 9 9 8 9 9 8 8 8 8 8 9 9 8 8 9 8 9 9 9 8 9 8 9 9 8 9 8 8 8 8 9 8 9 8 9 9 8 9 9 9 8 8 8 9 8 9 9 8 8 9 9 2 
2 9 8 8 9 8 8 8 9 8 8 8 9 8 8 8 9 8 9 8 9 9 9 9 9 9 8 8 8 8 9 9 8 8 9 9 8 9 8 8 9 9 8 8 9 9 8 8 8 8 9 8 9 8 8 8 8 8 8 8 9 8 9 2 
2 8 9 8 9 9 9 9 9 9 8 8 9 9 8 9 9 8 9 8 8 8 8 9 8 9 8 9 8 8 8 9 9 9 9 9 9 8 8 9 9 8 9 8 9 9 9 8 9 9 9 9 9 8 8 8 9 8 8 8 8 9 9 2 
2 9 8 9 8 8 9 8 9 9 8 9 8 9 9 9 9 8 9 8 8 9 8 8 8 9 8 9 8 8 9 8 8 9 8 8 8 9 9 8 9 9 9 9 9 8 9 8 9 8 9 8 8 8 9 9 9 8 8 9 8 9 9 2 
2 9 9 9 8 8 8 8 8 9 9 9 9 8 9 8 9 9 8 8 9 9 8 9 9 8 8 8 9 9 9 8 9 9 9 8 9 9 9 9 9 9 9 8 8 8 9 9 9 9 8 9 9 8 9 9 8 8 9 9 9 8 8 2 
2 8 8 9 9 8 9 9 8 9 8 8 8 8 9 8 8 9 8 8 9 8 9 8 9 9 8 8 9 8 8 9 9 9 8 9 9 8 8 8 9 8 9 8 9 9 8 9 8 8 9 8 8 9 8 8 8 8 8 9 8 8 8 2 
2 8 9 9 8 9 9 8 9 8 9 9 8 9 9 9 8 9 9 9 9 8 9 9 9 9 9 9 8 9 8 9 9 9 9 8 8 8 9 9 9 9 9 9 9 9 8 8 9 8 8 9 9 8 8 9 8 9 8 8 8 8 8 2 
2 9 8 9 9 9 9 9 9 8 9 8 9 8 9 8 8 8 8 8 8 8 8 9 9 9 8 8 8 9 8 8 8 8 8 8 9 8 8 9 9 9 9 8 9 9 8 9 9 8 9 8 9 9 8 9 8 8 9 9 8 8 8 2 
2 8 9 8 9 9 8 8 9 8 8 8 9 9 9 8 8 9 9 9 8 8 9 9 9 9 9 8 8 9 9 8 9 8 9 8 9 8 8 9 8 9 9 9 9 8 8 8 9 8 8 8 9 9 8 8 8 9 9 8 8 8 8 2 
2 9 8 8 9 9 8 9 8 9 9 8 8 9 9 8 8 8 9 8 9 9 8 9 9 8 9 8 9 9 9 8 8 9 9 8 9 8 8 9 9 8 9 9 8 8 9 9 8 9 8 8 8 8 8 9 9 9 9 8 8 9 9 2 
2 8 8 9 8 8 9 8 9 9 8 8 8 9 8 9 9 9 9 8 8 8 8 9 9 9 8 9 8 8 9 8 8 8 9 9 9 9 8 8 9 9 8 9 9 9 9 9 9 9 9 8 9 9 9 8 8 8 9 9 8 8 9 2 
2 8 8 8 8 8 8 8 9 9 9 9 9 9 8 8 8 9 8 9 9 8 8 8 9 8 9 9 9 9 9 9 9 9 8 8 8 9 9 9 8 8 8 8 8 9 8 8 8 8 8 8 8 9 8 9 8 8 8 9 9 8 9 2 
2 8 9 8 9 9 8 8 9 8 9 9 8 8 8 8 9 8 8 8 9 8 9 8 8 8 8 9 9 9 9 9 8 8 9 9 8 8 9 8 9 8 9 9 8 8 8 8 8 8 8 9 8 8 9 9 9 8 8 8 8 8 8 2 
2 8 9 8 8 8 9 8 8 9 9 9 8 9 9 9 8 8 9 8 9 9 8 9 8 9 8 8 8 9 8 9 8 8 8 8 9 8 9 8 8 9 8 8 8 9 9 8 8 9 8 8 8 9 9 8 9 9 8 8 8 8 8 2 
2 2 2 2 2 2 2 2 2 2 2 2 2 2 2 2 2 2 2 2 2 2 2 2 2 2 2 2 2 2 2 2 2 2 2 2 2 2 2 2 2 2 2 2 2 2 2 2 2 2 2 2 2 2 2 2 2 2 2 2 2 2 2 2 
