2 2 2 2 2 2 2 2 2 2 2 2 2 2 2 2 2 2 2 2 2 2 2 2 2 2 2 2 2 2 2 2 2 2 2 2 2 2 2 2 2 2 2 2 2 2 2 2 2 2 2 2 2 2 2 2 2 2 2 2 2 2 2 2 
2 9 10 9 9 9 9 10 9 10 10 10 10 10 10 9 9 9 10 10 9 10 9 10 9 9 10 10 10 10 10 10 9 10 9 9 9 10 10 9 9 9 10 9 10 9 10 10 9 9 9 10 9 10 9 10 9 10 9 10 10 9 9 2 
2 10 9 9 9 9 9 10 9 10 10 10 9 10 10 10 10 10 10 9 9 10 9 9 9 10 9 9 10 10 10 10 10 9 9 10 9 9 10 9 10 10 9 10 9 9 10 10 9 9 10 9 10 9 10 9 9 10 9 10 10 9 9 2 
2 10 9 10 10 10 9 10 9 9 10 10 10 10 10 9 9 9 9 9 9 10 9 10 9 9 9 10 9 9 10 9 9 9 10 10 10 9 9 9 9 9 10 10 10 10 9 10 9 10 10 9 10 9 9 10 10 10 10 9 9 9 10 2 
2 10 9 10 10 10 10 10 10 9 10 9 9 9 10 9 10 9 9 9 10 9 10 9 9 10 9 9 9 10 10 10 9 10 9 9 9 10 10 10 9 9 9 10 9 9 9 10 9 9 9 9 9 10 10 10 10 9 10 9 9 9 9 2 
2 9 9 10 10 9 10 10 9 9 9 10 10 9 10 10 9 10 10 9 10 10 9 10 9 10 9 10 9 9 9 9 10 9 9 9 10 10 10 10 9 10 10 10 9 9 9 9 10 10 9 9 10 9 9 9 9 10 10 10 10 9 9 2 
2 9 9 9 10 10 10 10 9 9 9 10 10 9 10 10 9 10 9 9 10 9 9 10 9 10 9 10 9 9 10 10 9 9 10 9 9 9 10 10 10 9 9 10 10 9 10 10 9 10 10 10 10 9 10 10 10 9 10 9 9 9 10 2 
2 10 9 10 9 9 9 9 10 9 9 9 10 10 9 10 10 9 10 10 10 10 9 10 9 9 9 9 10 9 9 10 9 10 10 9 9 10 9 9 10 10 9 10 10 9 10 10 10 9 9 9 9 9 10 9 10 10 10 10 9 10 9 2 
2 9 9 10 9 9 10 10 9 9 9 9 9 10 10 10 10 10 10 9 10 9 10 10 9 10 10 10 10 10 9 10 10 9 10 9 10 10 9 10 10 9 10 10 9 10 10 10 10 9 10 10 10 9 10 10 9 9 9 9 10 10 10 2 
2 9 9 10 10 9 10 10 10 10 9 10 10 9 10 10 10 9 9 9 10 10 9 9 10 10 9 10 10 9 10 10 10 10 10 10 9 9 10 10 9 10 10 9 10 9 9 10 9 10 9 9 10 10 9 10 9 9 10 9 10 10 9 2 
2 10 10 9 9 10 9 10 10 9 10 9 9 10 9 9 10 9 10 9 9 10 10 10 9 10 10 10 9 9 9 9 10 10 10 9 9 9 10 9 10 9 10 10 10 10 10 9 9 10 10 9 10 10 9 9 10 9 9 10 10 10 10 2 
2 9 9 9 10 9 10 9 10 9 10 10 10 10 10 10 9 10 10 10 9 9 10 10 10 9 10 9 9 9 10 9 9 9 10 9 10 10 9 10 9 10 10 10 9 9 10 9 10 9 9 9 9 9 10 10 10 10 9 10 10 10 9 2 
2 9 10 9 10 10 10 10 9 10 10 10 9 10 10 9 10 10 9 10 9 10 10 10 9 9 9 10 9 9 10 10 9 9 9 9 9 9 9 9 10 9 10 10 10 10 10 10 10 9 9 10 10 10 9 10 10 9 9 10 10 10 9 2 
2 10 9 9 9 9 9 10 10 9 10 9 10 9 9 9 9 9 10 10 10 9 10 10 10 9 9 9 10 10 9 9 10 10 9 9 9 9 10 9 10 9 10 9 9 9 9 10 9 10 10 9 9 10 10 9 10 9 9 9 9 9 9 2 
2 9 10 10 9 9 9 10 10 10 10 9 9 10 9 9 9 9 9 10 9 10 9 10 9 9 10 9 10 10 9 9 10 10 10 10 9 10 9 9 9 10 9 10 10 9 10 9 10 10 9 9 9 9 10 10 9 10 9 10 9 10 10 2 
2 10 10 9 10 9 10 10 9 9 10 9 10 9 9 10 9 10 10 9 9 10 10 10 10 9 9 9 9 9 9 9 10 9 9 9 9 9 10 10 9 9 10 10 9 9 10 9 9 9 10 10 10 9 10 9 10 9 9 10 10 10 9 2 
2 10 9 10 9 10 9 9 9 10 9 10 10 9 10 10 10 10 10 9 9 10 10 9 10 9 9 10 10 10 10 9 10 9 10 10 10 10 9 9 9 10 9 10 9 10 9 9 9 9 9 9 9 9 9 9 10 10 9 10 10 10 9 2 
2 10 9 10 10 10 9 9 9 9 10 9 9 10 9 9 10 9 9 10 9 9 9 9 9 9 10 9 10 10 9 10 9 9 10 10 9 10 10 10 9 10 10 9 9 9 9 10 10 10 10 9 9 10 9 9 9 10 10 10 9 10 9 2 
2 10 10 10 9 9 9 9 9 10 10 10 9 9 10 10 9 9 10 9 9 10 9 10 10 9 10 9 9 10 10 9 9 9 10 9 9 9 10 10 10 9 9 10 10 9 9 10 9 10 10 9 9 9 10 9 9 10 9 9 9 9 9 2 
2 10 9 9 9 9 10 10 10 10 9 10 10 10 9 9 10 9 10 9 10 10 9 10 10 10 9 10 9 9 10 9 10 10 9 9 10 10 9 9 10 10 10 10 9 9 9 9 10 10 10 9 10 10 9 10 9 9 9 10 10 9 10 2 
2 9 9 10 9 10 10 10 10 10 9 9 9 10 9 9 9 10 9 9 10 10 9 9 9 9 10 9 10 10 9 9 10 9 9 10 10 10 10 10 9 9 10 9 10 10 9 10 10 9 10 10 10 9 9 10 10 10 9 10 9 9 9 2 
2 9 10 10 9 10 9 10 10 10 10 9 9 10 9 10 10 9 9 9 9 9 10 9 9 10 9 9 9 9 9 9 10 10 9 9 9 9 10 9 10 10 9 9 9 9 9 10 10 10 9 10 9 10 10 10 9 9 9 9 9 10 9 2 
2 9 10 10 9 10 9 9 10 10 10 10 9 10 10 10 9 9 10 10 9 9 9 9 10 9 10 9 10 10 10 10 10 9 9 9 9 10 9 10 10 10 9 9 9 9 10 10 10 9 9 10 10 9 10 10 9 10 10 9 10 9 10 2 
2 10 10 10 10 10 10 10 9 10 10 10 9 10 9 10 10 9 10 10 9 10 9 9 10 9 9 10 9 9 9 10 9 9 9 10 9 9 10 9 9 10 10 9 10 10 10 10 10 10 9 10 10 9 9 9 9 10 9 9 10 10 10 2 
2 10 9 9 10 10 10 9 10 10 9 10 9 10 9 10 10 9 9 9 10 10 9 9 9 9 9 9 10 10 9 10 10 10 10 10 10 9 10 10 9 9 9 9 10 10 9 10 9 9 9 9 10 10 9 9 10 10 10 10 9 10 9 2 
2 10 9 10 9 9 10 10 9 10 9 9 9 10 9 9 9 10 9 9 10 10 9 10 10 9 10 9 9 9 10 10 9 9 10 10 9 9 9 10 9 9 9 10 10 10 9 9 9 10 9 9 9 9 10 10 10 9 9 9 9 9 9 2 
2 10 10 9 9 10 9 10 10 9 9 10 9 10 9 10 9 9 9 10 10 9 9 9 9 10 9 9 10 9 9 10 9 9 9 10 9 9 10 9 10 10 9 9 9 9 10 9 9 10 9 9 10 9 9 9 9 10 10 9 10 10 9 2 
2 10 9 10 9 10 10 9 9 9 10 10 9 10 9 9 10 10 10 9 10 10 9 10 9 10 10 10 9 9 9 10 9 9 9 10 9 10 10 9 10 9 10 9 9 10 10 9 9 9 10 10 10 9 9 10 9 10 10 10 10 9 10 2 
2 9 9 9 9 9 10 10 9 10 9 10 10 10 10 9 9 10 9 9 10 9 9 10 9 9 9 9 9 10 10 9 9 10 10 9 10 10 10 9 10 9 10 9 9 9 9 10 10 10 10 10 10 10 9 10 10 9 10 9 10 10 10 2 
2 10 9 10 9 10 9 10 10 10 10 9 9 10 10 10 9 9 10 9 10 10 10 10 9 9 9 9 9 10 10 9 10 10 9 10 10 9 10 10 10 10 10 9 10 10 10 9 9 9 10 9 9 9 9 9 10 10 9 10 10 9 9 2 
2 9 9 10 10 9 10 9 9 10 10 9 9 10 10 10 10 9 9 10 10 9 9 9 9 9 9 10 9 10 10 9 10 10 10 9 10 9 10 10 9 9 10 10 10 9 9 10 9 10 9 9 9 9 10 10 9 9 10 9 9 9 9 2 
2 9 10 10 10 9 9 10 9 9 9 10 10 10 10 10 10 9 9 9 9 10 10 9 10 9 9 10 9 10 9 9 9 9 10 9 9 9 10 9 10 10 9 9 10 10 9 10 9 9 9 10 10 10 10 9 9 10 10 9 10 9 10 2 
2 10 9 9 10 10 9 10 9 10 10 10 10 9 9 9 9 10 10 9 10 9 9 9 9 9 10 9 9 10 9 10 10 10 10 9 9 9 9 10 9 10 9 9 10 9 10 10 9 10 9 9 9 10 9 9 9 10 10 9 10 9 10 2 
2 10 9 9 10 10 9 9 10 9 9 9 10 10 10 10 10 10 9 10 9 9 9 9 10 9 10 9 9 10 9 10 9 9 10 9 10 10 10 10 9 10 10 9 9 10 10 9 10 10 10 10 9 10 9 9 10 10 10 10 9 10 10 2 
2 10 10 10 9 10 10 9 9 10 9 9 9 9 10 10 10 10 9 10 9 9 9 10 10 10 9 10 9 10 10 9 10 9 10 9 9 10 9 9 10 9 9 10 9 10 9 10 9 10 9 10 9 10 9 10 10 9 10 10 9 10 9 2 
2 9 10 9 10 10 10 9 9 9 9 10 10 10 10 9 10 10 10 10 9 10 9 9 9 9 9 10 10 10 9 9 9 10 9 10 9 9 10 10 9 9 10 9 10 10 9 10 9 9 10 10 10 9 10 9 9 9 10 10 10 10 9 2 
2 10 9 9 9 10 10 9 10 10 10 9 10 10 10 9 9 10 10 9 10 10 9 9 10 10 10 10 9 10 9 10 10 10 9 10 9 10 10 10 9 9 9 10 9 10 9 9 9 9 10 9 9 10 10 9 10 9 9 9 9 10 9 2 
2 9 10 9 10 9 10 10 9 10 9 10 9 9 10 10 10 9 10 10 9 10 9 9 10 9 10 9 10 9 9 9 10 9 9 10 9 10 10 10 10 9 9 9 10 9 10 9 9 9 10 10 9 10 9 10 10 9 9 9 9 9 9 2 
2 9 10 10 9 10 10 9 10 9 9 10 9 10 9 9 9 9 10 10 9 10 9 9 9 9 9 10 10 9 10 9 10 9 10 10 9 9 9 10 9 9 10 10 10 9 9 10 10 10 10 9 9 9 9 10 9 9 9 9 9 9 10 2 
2 9 9 9 9 9 10 9 9 10 9 10 9 10 9 9 10 10 9 10 10 9 9 9 10 9 10 10 9 10 9 10 10 9 10 9 10 10 9 10 9 9 10 9 9 10 9 10 9 10 10 9 10 9 9 10 9 9 9 9 9 10 10 2 
2 9 10 10 9 9 9 9 10 10 10 9 9 9 9 10 9 9 9 10 10 9 10 10 10 10 10 9 10 10 9 10 9 9 9 9 9 10 9 9 10 9 10 10 10 10 10 10 9 10 10 10 10 9 10 10 10 10 10 9 9 10 9 2 
2 9 10 10 9 9 10 9 10 9 9 10 10 10 10 9 9 10 9 9 10 10 10 10 10 9 9 10 9 10 9 9 9 10 9 9 10 10 9 9 10 9 9 9 10 9 9 10 9 10 10 9 9 10 10 10 9 10 9 9 10 9 10 2 
2 9 9 9 10 10 9 9 9 9 9 10 10 9 10 9 9 9 10 10 10 10 10 9 9 9 10 10 9 10 9 9 9 9 9 10 9 10 10 9 10 10 9 10 10 10 9 9 9 10 10 10 9 9 10 10 10 9 9 9 9 10 10 2 
2 10 9 10 9 10 9 9 10 9 10 10 10 10 9 9 9 10 9 10 9 10 9 9 9 10 9 9 9 10 10 10 10 9 9 9 10 10 10 9 10 10 9 10 10 9 9 10 9 10 10 9 10 10 9 9 10 9 10 10 10 9 10 2 
2 10 10 10 9 10 10 10 9 9 10 9 9 10 9 10 9 10 10 10 9 10 10 9 9 10 10 10 9 9 9 10 10 10 9 10 10 10 9 9 9 10 9 9 10 9 9 10 9 10 10 9 10 9 10 10 10 9 10 9 9 9 10 2 
2 10 9 10 9 10 9 10 9 10 10 9 9 9 9 9 9 9 9 9 10 10 10 10 10 10 9 9 10 10 9 10 10 10 10 9 9 9 9 10 10 9 9 10 10 10 10 10 10 10 10 9 10 10 10 9 9 10 9 9 10 10 9 2 
2 10 10 9 9 10 10 9 10 10 9 10 10 10 9 10 9 9 10 10 10 9 9 10 9 9 9 9 10 10 10 9 10 10 9 9 9 10 10 10 10 10 9 9 10 9 10 10 10 10 10 10 2 10 9 10 10 9 9 9 9 10 10 2 
2 10 10 10 10 9 9 9 9 9 10 9 9 9 9 9 9 9 10 9 10 10 10 9 10 9 10 10 9 9 9 10 9 10 10 9 10 10 10 9 10 9 9 9 10 10 9 10 9 9 10 10 9 9 10 9 10 10 10 10 9 9 10 2 
2 10 10 9 10 10 10 10 10 9 9 10 9 10 9 10 10 10 10 10 10 9 9 10 9 9 10 10 10 9 9 10 10 10 10 10 9 10 9 9 9 9 10 10 9 9 9 10 10 9 10 10 10 10 9 10 10 10 10 10 9 9 10 2 
2 10 9 9 10 9 10 9 9 9 9 10 10 10 9 10 9 9 10 9 9 9 9 10 10 10 10 9 10 10 9 9 10 10 9 10 9 9 10 10 9 9 9 9 10 10 10 9 10 9 9 10 9 9 9 10 10 10 9 10 10 9 10 2 
2 9 10 9 9 9 9 9 9 10 10 10 10 10 9 9 10 10 9 9 10 10 9 9 9 10 9 10 9 9 10 9 9 9 9 9 9 9 9 9 9 10 9 9 10 9 10 9 10 10 9 9 10 10 10 10 9 10 10 9 9 9 10 2 
2 10 9 9 10 9 9 10 10 9 10 10 10 10 9 10 9 9 9 9 10 9 10 10 10 10 9 9 9 9 9 9 10 10 9 10 9 10 10 10 9 9 10 9 9 10 9 10 10 9 10 9 9 10 9 9 9 9 10 10 10 9 9 2 
2 9 9 9 10 10 10 10 10 10 9 10 9 9 9 9 10 9 9 9 10 9 10 9 9 10 9 9 10 9 9 10 9 10 9 9 10 10 10 9 10 9 10 9 10 9 10 9 10 9 10 10 10 9 10 10 10 9 10 9 10 10 10 2 
2 10 9 9 10 9 10 9 9 10 10 10 10 9 10 10 10 10 9 9 9 10 9 10 9 10 10 10 9 9 9 9 9 10 9 9 10 9 9 10 10 9 10 9 10 10 10 9 9 9 9 10 9 10 9 10 9 10 9 9 10 9 9 2 
2 9 10 10 9 9 9 9 9 9 10 9 10 10 10 10 10 9 10 10 10 9 10 10 9 10 10 10 10 10 9 10 9 10 9 9 9 9 10 10 9 9 9 10 9 10 9 10 10 9 10 9 10 10 10 9 10 9 9 9 10 9 9 2 
2 10 9 9 9 10 9 10 10 10 10 10 9 10 9 9 10 10 9 10 10 10 10 10 9 10 10 9 9 9 10 9 9 9 9 10 9 9 10 10 10 9 10 10 9 10 9 10 10 10 10 9 10 9 9 10 9 10 9 9 10 9 9 2 
2 10 10 10 10 10 10 10 10 9 9 10 9 10 9 9 10 9 10 10 9 10 9 9 10 9 9 9 10 9 10 9 10 9 9 9 9 10 10 10 10 9 10 9 10 10 10 9 10 9 10 9 9 9 9 10 9 10 10 10 10 10 9 2 
2 9 9 10 9 10 9 10 10 9 9 10 10 10 9 10 10 9 9 10 9 9 10 10 10 9 9 9 9 10 10 10 9 10 9 10 9 10 10 9 9 10 10 10 9 9 9 10 10 10 9 10 9 9 10 10 9 9 9 9 10 9 10 2 
2 9 9 10 9 10 9 9 9 9 9 9 9 9 9 9 10 9 10 9 9 10 9 9 9 10 10 10 9 10 10 9 10 9 10 10 9 10 10 9 9 9 10 9 10 9 9 9 9 9 10 9 10 9 10 10 10 10 9 10 10 10 9 2 
2 9 10 9 10 10 10 9 9 9 9 10 9 10 10 10 10 9 10 10 10 9 9 9 9 10 9 10 9 10 10 10 9 9 9 9 10 9 10 9 10 10 10 10 10 9 9 9 10 9 10 10 9 9 10 9 9 9 9 10 9 10 10 2 
2 9 10 9 10 10 10 9 9 10 10 9 9 9 9 9 10 9 9 9 10 10 9 10 9 10 9 10 9 9 9 10 10 9 10 10 9 9 10 9 10 9 10 10 9 10 9 9 9 9 9 10 10 9 10 9 10 10 9 9 9 9 10 2 
2 9 9 9 10 9 10 10 9 10 9 10 10 9 9 9 10 9 10 10 9 10 9 10 10 9 10 10 9 10 9 10 10 10 10 9 10 10 10 10 10 9 9 9 9 10 9 9 10 9 10 9 10 9 10 10 9 9 9 9 10 10 10 2 
2 9 9 9 10 10 10 10 9 9 9 9 10 9 9 9 9 10 9 9 9 9 9 9 10 9 9 9 9 10 10 9 10 10 9 9 9 10 9 10 10 10 10 10 10 9 10 10 9 9 10 9 10 9 9 9 9 10 10 10 9 10 10 2 
2 2 2 2 2 2 2 2 2 2 2 2 2 2 2 2 2 2 2 2 2 2 2 2 2 2 2 2 2 2 2 2 2 2 2 2 2 2 2 2 2 2 2 2 2 2 2 2 2 2 2 2 2 2 2 2 2 2 2 2 2 2 2 2 
